rank,name,opening_rev,total_rev,non_opening_rev,percent_of_total,theatres,avg_theatre_rev,release_date,distributor,tomatometer_rating,tomatometer_status,tomatometer_count,audience_status,audience_count,audience_top_critics_count,audience_fresh_critics_count,audience_rotten_critics_count
1,Avengers: Endgame,357115007,858373000,501257993,41.6,4662,76601,26/04/2019,Walt Disney Studios Motion Pictures,94,Certified Fresh,486,Upright,66152,54,458,28
2,Avengers: Infinity War,257698183,678815482,421117299,38,4474,57599,27/04/2018,Walt Disney Studios Motion Pictures,85,Certified Fresh,448,Upright,56998,53,381,67
3,Star Wars: Episode VII - The Force Awakens,247966675,936662225,688695550,26.5,4134,59982,18/12/2015,Walt Disney Studios Motion Pictures,93,Certified Fresh,418,Upright,231305,60,387,31
5,Jurassic World,208806270,652270625,443464355,32,4274,48855,12/6/2015,Universal Pictures,72,Fresh,337,Upright,225307,52,242,95
6,Black Panther,202003951,700059566,498055615,28.9,4020,50249,16/02/2018,Walt Disney Studios Motion Pictures,97,Certified Fresh,487,Upright,88211,56,470,17
7,The Lion King,191770759,543638043,351867284,35.3,4725,40586,19/07/2019,Walt Disney Studios Motion Pictures,93,Certified Fresh,128,Upright,1269333,27,119,9
8,Avengers: Age of Ultron,191271109,459005868,267734759,41.7,4276,44731,1/5/2015,Walt Disney Studios Motion Pictures,75,Certified Fresh,355,Upright,287805,58,267,88
9,Incredibles 2,182687905,608581744,425893839,30,4410,41425,15/06/2018,Walt Disney Studios Motion Pictures,94,Certified Fresh,363,Upright,17666,52,340,23
10,Captain America: Civil War,179139142,408084349,228945207,43.9,4226,42389,6/5/2016,Walt Disney Studios Motion Pictures,91,Certified Fresh,398,Upright,179151,60,362,36
11,Beauty and the Beast,174750616,504014165,329263549,34.7,4210,41508,17/03/2017,Walt Disney Studios Motion Pictures,94,Certified Fresh,115,Upright,759862,32,108,7
13,Iron Man 3,174144585,409013994,234869409,42.6,4253,40946,3/5/2013,Walt Disney Studios Motion Pictures,79,Certified Fresh,315,Upright,484450,54,249,66
14,Batman v Superman: Dawn of Justice,166007347,330360194,164352847,50.2,4242,39134,25/03/2016,Warner Bros.,28,Rotten,412,Upright,233695,60,116,296
16,The Dark Knight Rises,160887295,448139099,287251804,35.9,4404,36532,20/07/2012,Warner Bros.,87,Certified Fresh,360,Upright,1210957,60,313,47
17,The Dark Knight,158411483,533345358,374933875,29.7,4366,36282,18/07/2008,Warner Bros.,94,Certified Fresh,335,Upright,1831566,59,316,19
18,The Hunger Games: Catching Fire,158074286,424668047,266593761,37.2,4163,37971,22/11/2013,Lionsgate,89,Certified Fresh,282,Upright,424053,59,252,30
19,Rogue One: A Star Wars Story,155081681,532177324,377095643,29.1,4157,37306,16/12/2016,Walt Disney Studios Motion Pictures,84,Certified Fresh,432,Upright,102502,63,361,71
20,Captain Marvel,153433423,426829839,273396416,36,4310,35599,8/3/2019,Walt Disney Studios Motion Pictures,78,Certified Fresh,497,Spilled,92982,49,389,108
21,The Hunger Games,152535747,408010692,255474945,37.4,4137,36871,23/03/2012,Lionsgate,84,Certified Fresh,301,Upright,902294,54,253,48
22,Spider-Man 3,151116516,336530303,185413787,44.9,4252,35540,4/5/2007,Sony Pictures Releasing,63,Fresh,256,Spilled,2265043,57,160,96
23,Jurassic World: Fallen Kingdom,148024610,417719760,269695150,35.4,4475,33078,22/06/2018,Universal Pictures,48,Rotten,409,Spilled,29336,57,195,214
24,Furious 7,147187040,353007020,205819980,41.7,4004,36760,3/4/2015,Universal Pictures,81,Certified Fresh,266,Upright,194777,52,216,50
25,Guardians of the Galaxy Vol. 2,146510104,389813101,243302997,37.6,4347,33703,5/5/2017,Walt Disney Studios Motion Pictures,84,Certified Fresh,395,Upright,108021,55,333,62
26,The Twilight Saga: New Moon,142839137,296623634,153784497,48.2,4024,35496,20/11/2009,Summit Entertainment,28,Rotten,226,Upright,577776,54,63,163
27,Pirates of the Caribbean: Dead Man's Chest,135634554,423315812,287681258,32,4133,32817,7/7/2006,Walt Disney Studios Motion Pictures,53,Rotten,225,Upright,1847651,49,119,106
30,Finding Dory,135060273,486295561,351235288,27.8,4305,31372,17/06/2016,Walt Disney Studios Motion Pictures,94,Certified Fresh,322,Upright,181602,59,303,19
31,Suicide Squad,133682248,325100054,191417806,41.1,4255,31417,5/8/2016,Warner Bros.,27,Rotten,366,Spilled,145029,60,99,267
32,Deadpool,132434639,363070709,230636070,36.5,3558,37221,12/2/2016,Twentieth Century Fox,84,Certified Fresh,335,Upright,186846,48,283,52
33,Iron Man 2,128122480,312433331,184310851,41,4380,29251,7/5/2010,Paramount Pictures,73,Certified Fresh,295,Upright,480154,53,216,79
35,Deadpool 2,125507153,318491426,192984273,39.4,4349,28858,18/05/2018,Twentieth Century Fox,84,Certified Fresh,396,Upright,30989,49,331,65
36,It,123403419,327481748,204078329,37.7,4103,30076,8/9/2017,Warner Bros.,100,Fresh,11,Upright,4769,1,11,0
38,Thor: Ragnarok,122744989,315058289,192313300,39,4080,30084,3/11/2017,Walt Disney Studios Motion Pictures,93,Certified Fresh,402,Upright,93345,49,372,30
39,The Hunger Games: Mockingjay - Part 1,121897634,337135885,215238251,36.2,4151,29365,21/11/2014,Lionsgate,69,Fresh,288,Upright,246722,55,198,90
40,Shrek the Third,121629270,322719944,201090674,37.7,4122,29507,18/05/2007,DreamWorks,41,Rotten,211,Spilled,2218576,50,86,125
41,Toy Story 4,120908065,434038008,313129943,27.9,4575,26427,21/06/2019,Walt Disney Studios Motion Pictures,97,Certified Fresh,404,Upright,53114,46,393,11
42,Spider-Man: Homecoming,117027503,334201140,217173637,35,4348,26915,7/7/2017,Sony Pictures Releasing,92,Certified Fresh,378,Upright,107020,50,348,30
43,Man of Steel,116619362,291045518,174426156,40.1,4207,27720,14/06/2013,Warner Bros.,56,Rotten,329,Upright,448127,56,184,145
44,Alice in Wonderland,116101023,334191110,218090087,34.7,3728,31142,5/3/2010,Walt Disney Studios Motion Pictures,81,Fresh,31,Upright,574219,6,25,6
45,Minions,115718405,336045770,220327365,34.4,4301,26905,10/7/2015,Universal Pictures,55,Rotten,216,Spilled,136741,39,119,97
46,Spider-Man,114844116,403706375,288862259,28.4,3615,31768,3/5/2002,Sony Pictures Releasing,90,Certified Fresh,243,Upright,34297354,48,218,25
47,Toy Story 3,110307189,415004880,304697691,26.6,4028,27385,18/06/2010,Walt Disney Studios Motion Pictures,98,Certified Fresh,305,Upright,606931,54,300,5
49,Transformers: Revenge of the Fallen,108966307,402111870,293145563,27.1,4234,25736,24/06/2009,DreamWorks,20,Rotten,250,Spilled,4081606,54,50,200
50,Star Wars: Episode III - Revenge of the Sith,108435841,380270577,271834736,28.5,3661,29619,19/05/2005,Twentieth Century Fox,80,Certified Fresh,295,Upright,33683838,57,235,60
51,Shrek 2,108037878,441226247,333188369,24.5,4163,25951,19/05/2004,DreamWorks Distribution,89,Certified Fresh,236,Upright,34232524,53,209,27
52,The Secret Life of Pets,104352905,368384330,264031425,28.3,4370,23879,8/7/2016,Universal Pictures,73,Certified Fresh,226,Upright,82326,46,166,60
53,The Jungle Book,103261464,364001123,260739659,28.4,4028,25635,15/04/2016,Walt Disney Studios Motion Pictures,87,Fresh,39,Upright,714943,5,34,5
54,Wonder Woman,103251471,412563408,309311937,25,4165,24790,2/6/2017,Warner Bros.,82,Fresh,11,Upright,8546,0,9,2
55,X-Men: The Last Stand,102750665,234362462,131611797,43.8,3690,27845,26/05/2006,Twentieth Century Fox,57,Rotten,238,Upright,1074092,51,136,102
56,Harry Potter and the Goblet of Fire,102685961,290013036,187327075,35.4,3858,26616,18/11/2005,Warner Bros.,88,Certified Fresh,253,Upright,34153607,52,222,31
57,The Hunger Games: Mockingjay - Part 2,102665981,281723902,179057921,36.4,4175,24590,20/11/2015,Lionsgate,70,Fresh,280,Upright,201029,50,196,84
58,Indiana Jones and the Kingdom of the Crystal Skull,100137835,317101119,216963284,31.6,4260,23506,22/05/2008,Paramount Pictures,78,Certified Fresh,271,Spilled,1320350,54,211,60
59,Transformers: Age of Extinction,100038390,245439076,145400686,40.8,4233,23632,27/06/2014,Paramount Pictures,18,Rotten,206,Spilled,223825,52,37,169
60,The Fate of the Furious,98786705,226008385,127221680,43.7,4310,22920,14/04/2017,Universal Pictures,67,Fresh,299,Upright,44016,50,200,99
61,Iron Man,98618668,318604126,219985458,31,4105,24024,2/5/2008,Paramount Pictures,94,Certified Fresh,277,Upright,1082059,56,259,18
62,Transformers: Dark of the Moon,97852865,352390543,254537678,27.8,4088,23936,29/06/2011,DreamWorks,35,Rotten,260,Spilled,257413,52,92,168
63,Fast & Furious 6,97375245,238679850,141304605,40.8,3658,26619,24/05/2013,Universal Pictures,70,Fresh,203,Upright,348559,42,142,61
64,Captain America: The Winter Soldier,95023721,259766572,164742851,36.6,3938,24129,4/4/2014,Walt Disney Studios Motion Pictures,90,Certified Fresh,292,Upright,281524,51,263,29
66,Guardians of the Galaxy,94320883,333176600,238855717,28.3,4080,23117,1/8/2014,Walt Disney Studios Motion Pictures,91,Certified Fresh,316,Upright,254717,56,288,28
67,Justice League,93842239,229024295,135182056,41,4051,23165,17/11/2017,Warner Bros.,40,Rotten,380,Upright,126790,50,152,228
68,Harry Potter and the Prisoner of Azkaban,93687367,249541069,155853702,37.5,3855,24302,4/6/2004,Warner Bros.,90,Certified Fresh,257,Upright,1167820,55,232,25
69,Godzilla,93188384,200676069,107487685,46.4,3952,23580,16/05/2014,Warner Bros.,16,Rotten,76,Spilled,302817,12,12,64
70,The Matrix Reloaded,91774413,281576461,189802048,32.6,3603,25471,15/05/2003,Warner Bros.,73,Certified Fresh,245,Upright,942408,51,179,66
72,The Amazing Spider-Man 2,91608337,202853933,111245596,45.2,4324,21186,2/5/2014,Sony Pictures Releasing,52,Rotten,302,Upright,221903,59,157,145
73,Aladdin,91500929,355559216,264058287,25.7,4476,20442,24/05/2019,Walt Disney Studios Motion Pictures,57,Rotten,353,Upright,59029,44,202,151
74,X-Men: Days of Future Past,90823660,233921534,143097874,38.8,3996,22728,23/05/2014,Twentieth Century Fox,90,Certified Fresh,318,Upright,276699,56,286,32
76,Inside Out,90440272,356461711,266021439,25.4,3946,22919,19/06/2015,Walt Disney Studios Motion Pictures,98,Certified Fresh,357,Upright,136125,57,350,7
77,Harry Potter and the Sorcerer's Stone,90294621,317575550,227280929,28.4,3672,24590,16/11/2001,Warner Bros.,81,Certified Fresh,197,Upright,1157306,46,159,38
78,Pirates of the Caribbean: On Stranger Tides,90151958,241071802,150919844,37.4,4155,21697,20/05/2011,Walt Disney Studios Motion Pictures,33,Rotten,274,Spilled,199489,49,90,184
79,Logan,88411916,226277068,137865152,39.1,4071,21717,3/3/2017,Twentieth Century Fox,93,Certified Fresh,397,Upright,92042,56,370,27
80,Skyfall,88364714,304360277,215995563,29,3505,25211,9/11/2012,Sony Pictures Releasing,92,Certified Fresh,370,Upright,373527,58,339,31
81,Harry Potter and the Chamber of Secrets,88357488,261988482,173630994,33.7,3682,23997,15/11/2002,Warner Bros.,83,Certified Fresh,235,Upright,1150581,53,194,41
82,Spider-Man 2,88156227,373585825,285429598,23.6,4152,21232,30/06/2004,Sony Pictures Releasing,93,Certified Fresh,272,Upright,1151886,52,254,18
83,Fast Five,86198765,209837675,123638910,41.1,3644,23654,29/04/2011,Universal Pictures,77,Certified Fresh,198,Upright,139528,43,152,46
84,The Hangover Part II,85946294,254464305,168518011,33.8,3615,23774,26/05/2011,Warner Bros.,33,Rotten,243,Spilled,196111,53,81,162
85,Thor: The Dark World,85737841,206362140,120624299,41.6,3841,22321,8/11/2013,Walt Disney Studios Motion Pictures,67,Fresh,269,Upright,310166,52,179,90
86,X2: X-Men United,85558731,214949694,129390963,39.8,3741,22870,2/5/2003,Twentieth Century Fox,85,Certified Fresh,244,Upright,977220,53,207,37
87,Fifty Shades of Grey,85171450,166167230,80995780,51.3,3646,23360,13/02/2015,Universal Pictures,24,Rotten,275,Spilled,83607,56,67,208
88,Doctor Strange,85058311,232641920,147583609,36.6,3882,21910,4/11/2016,Walt Disney Studios Motion Pictures,89,Certified Fresh,358,Upright,109580,52,319,39
89,The Hobbit: An Unexpected Journey,84617303,303003568,218386265,27.9,4045,20918,14/12/2012,Warner Bros.,64,Fresh,298,Upright,482887,53,192,106
91,Solo: A Star Wars Story,84420489,213767512,129347023,39.5,4381,19269,25/05/2018,Walt Disney Studios Motion Pictures,70,Fresh,460,Upright,42003,57,323,137
92,The Passion of the Christ,83848082,370274604,286426522,22.6,3043,27554,25/02/2004,Newmarket Films,49,Rotten,275,Upright,369185,55,134,141
93,Despicable Me 2,83517315,368065385,284548070,22.7,3997,20895,3/7/2013,Universal Pictures,75,Certified Fresh,182,Upright,369617,41,136,46
94,Monsters University,82429469,268492764,186063295,30.7,4004,20586,21/06/2013,Walt Disney Studios Motion Pictures,80,Certified Fresh,198,Upright,305223,47,158,40
95,Venom,80255756,213515506,133259750,37.6,4250,18883,5/10/2018,Sony Pictures Releasing,43,Rotten,7,Spilled,3071,1,3,4
96,Star Wars: Episode II - Attack of the Clones,80027814,302191252,222163438,26.5,3161,25317,16/05/2002,Twentieth Century Fox,66,Fresh,250,Spilled,852484,53,164,86
97,Oz the Great and Powerful,79110453,234911825,155801372,33.7,3912,20222,8/3/2013,Walt Disney Studios Motion Pictures,58,Rotten,262,Spilled,292934,51,152,110
98,Harry Potter and the Half-Blood Prince,77835727,301959197,224123470,25.8,4325,17996,15/07/2009,Warner Bros.,83,Certified Fresh,276,Upright,1558838,59,230,46
99,I Am Legend,77211321,256393010,179181689,30.1,3606,21411,14/12/2007,Warner Bros.,68,Fresh,213,Upright,1129654,54,145,68
100,Harry Potter and the Order of the Phoenix,77108414,292004738,214896324,26.4,4285,17994,11/7/2007,Warner Bros.,78,Certified Fresh,250,Upright,2332946,52,194,56
101,The Da Vinci Code,77073388,217536138,140462750,35.4,3735,20635,19/05/2006,Sony Pictures Releasing,25,Rotten,228,Spilled,761284,49,57,171
102,Avatar,77025481,749766139,672740658,10.3,3452,22313,18/12/2009,Twentieth Century Fox,82,Certified Fresh,308,Upright,1381988,57,252,56
103,Halloween,76221545,159342015,83120470,47.8,3928,19404,19/10/2018,Universal Pictures,96,Certified Fresh,68,Upright,302801,10,65,3
104,Ant-Man and the Wasp,75812205,216648740,140836535,35,4206,18024,6/7/2018,Walt Disney Studios Motion Pictures,88,Certified Fresh,405,Upright,23730,51,356,49
105,Star Trek,75204289,257730019,182525730,29.2,3849,19538,8/5/2009,Paramount Pictures,94,Certified Fresh,348,Upright,747491,61,328,20
106,Zootopia,75063401,341268248,266204847,22,3827,19614,4/3/2016,Walt Disney Studios Motion Pictures,97,Certified Fresh,279,Upright,100946,47,272,7
107,Fantastic Beasts and Where to Find Them,74403387,234037575,159634188,31.8,4144,17954,18/11/2016,Warner Bros.,75,Certified Fresh,326,Upright,87522,55,243,83
108,The Simpsons Movie,74036787,183135014,109098227,40.4,3922,18877,27/07/2007,Twentieth Century Fox,88,Certified Fresh,221,Upright,1823188,50,194,27
109,The Hobbit: The Desolation of Smaug,73645197,258366855,184721658,28.5,3903,18868,13/12/2013,Warner Bros.,74,Certified Fresh,237,Upright,264021,47,176,61
110,Austin Powers in Goldmember,73071188,213307889,140236701,34.3,3613,20224,26/07/2002,New Line Cinema,54,Rotten,185,Spilled,32935203,40,100,85
111,The Lord of the Rings: The Return of the King,72629713,377027325,304397612,19.3,3703,19613,17/12/2003,New Line Cinema,93,Certified Fresh,273,Upright,34679773,52,255,18
112,Despicable Me 3,72434025,264624300,192190275,27.4,4529,15993,30/06/2017,Universal Pictures,58,Rotten,190,Spilled,78424,31,110,80
114,Us,71117625,175084580,103966955,40.6,3741,19010,22/03/2019,Universal Pictures,93,Certified Fresh,494,Upright,10978,54,461,33
116,Fast & Furious,70950500,155064265,84113765,45.8,3461,20500,3/4/2009,Universal Pictures,29,Rotten,174,Upright,491390,39,50,124
117,300,70885301,210614939,139729638,33.7,3103,22844,9/3/2007,Warner Bros.,60,Fresh,231,Upright,1434714,50,139,92
118,Shrek Forever After,70838207,238736787,167898580,29.7,4359,16251,21/05/2010,DreamWorks,58,Rotten,196,Spilled,352806,43,113,83
119,Transformers,70502384,319246193,248743809,22.1,4011,17577,3/7/2007,DreamWorks,58,Rotten,226,Upright,2385106,50,130,96
120,The Incredibles,70467623,261441092,190973469,27,3933,17917,5/11/2004,Walt Disney Studios Motion Pictures,97,Certified Fresh,242,Upright,32604129,48,235,7
121,Spectre,70403148,200074609,129671461,35.2,3929,17918,6/11/2015,Sony Pictures Releasing,63,Fresh,347,Upright,105638,53,220,127
122,Finding Nemo,70251710,339714978,269463268,20.7,3374,20821,30/05/2003,Walt Disney Studios Motion Pictures,99,Certified Fresh,263,Upright,33356856,60,261,2
123,Star Trek Into Darkness,70165559,228778661,158613102,30.7,3868,18140,16/05/2013,Paramount Pictures,84,Certified Fresh,284,Upright,312591,54,239,45
125,Twilight,69637740,192769854,123132114,36.1,3419,20367,21/11/2008,Summit Entertainment,60,Fresh,55,Spilled,4194,14,33,22
126,Maleficent,69431298,241410378,171979080,28.8,3948,17586,30/05/2014,Walt Disney Studios Motion Pictures,53,Rotten,264,Upright,175980,52,141,123
127,The Bourne Ultimatum,69283690,227471070,158187380,30.5,3660,18929,3/8/2007,Universal Pictures,92,Certified Fresh,264,Upright,1922540,54,244,20
128,Pitch Perfect 2,69216890,184296230,115079340,37.6,3473,19930,15/05/2015,Universal Pictures,66,Fresh,211,Upright,79402,47,139,72
129,The Day After Tomorrow,68743584,186740799,117997215,36.8,3425,20071,28/05/2004,Twentieth Century Fox,44,Rotten,219,Spilled,32749429,46,97,122
131,Planet of the Apes,68532960,180011740,111478780,38.1,3500,19580,27/07/2001,Twentieth Century Fox,88,Certified Fresh,58,Upright,118954,11,51,7
132,The Mummy Returns,68139035,202019785,133880750,33.7,3401,20035,4/5/2001,Universal Pictures,47,Rotten,140,Upright,748315,36,66,74
133,Up,68108790,293004164,224895374,23.2,3766,18085,29/05/2009,Walt Disney Studios Motion Pictures,98,Certified Fresh,293,Upright,1203508,56,286,7
134,Bruce Almighty,67953330,242829261,174875931,28,3483,19510,23/05/2003,Universal Pictures,48,Rotten,190,Spilled,33024215,45,92,98
136,Cinderella,67877361,201151353,133273992,33.7,3845,17653,13/03/2015,Walt Disney Studios Motion Pictures,97,Fresh,33,Upright,862072,7,32,1
137,Quantum of Solace,67528882,168368427,100839545,40.1,3451,19567,14/11/2008,Sony Pictures Releasing,65,Fresh,291,Spilled,431599,54,189,102
140,Rush Hour 2,67408222,226164286,158756064,29.8,3118,21619,3/8/2001,New Line Cinema,52,Rotten,127,Upright,893941,35,66,61
141,World War Z,66411834,202359711,135947877,32.8,3607,18411,21/06/2013,Paramount Pictures,66,Fresh,272,Upright,304887,55,180,92
142,Brave,66323594,237283207,170959613,28,4164,15927,22/06/2012,Walt Disney Studios Motion Pictures,78,Certified Fresh,243,Upright,279048,51,190,53
143,Cars 2,66135507,191452396,125316889,34.5,4115,16071,24/06/2011,Walt Disney Studios Motion Pictures,39,Rotten,215,Spilled,103439,49,83,132
144,X-Men: Apocalypse,65769562,155442489,89672927,42.3,4150,15848,27/05/2016,Twentieth Century Fox,47,Rotten,333,Upright,127400,50,156,177
145,Thor,65723338,181030624,115307286,36.3,3955,16617,6/5/2011,Paramount Pictures,78,Certified Fresh,282,Upright,247197,53,219,63
146,Teenage Mutant Ninja Turtles,65575105,191204754,125629649,34.3,3845,17054,8/8/2014,Paramount Pictures,22,Rotten,151,Spilled,131934,41,33,118
147,2012,65237614,166112167,100874553,39.3,3404,19164,13/11/2009,Sony Pictures Releasing,39,Rotten,242,Spilled,508140,48,95,147
149,Captain America: The First Avenger,65058524,176654505,111595981,36.8,3715,17512,22/07/2011,Paramount Pictures,80,Certified Fresh,265,Upright,188705,52,212,53
150,War of the Worlds,64878725,234280354,169401629,27.7,3908,16601,29/06/2005,Paramount Pictures,75,Certified Fresh,259,Spilled,32518946,51,194,65
151,The Twilight Saga: Eclipse,64832191,300531751,235699560,21.6,4468,14510,30/06/2010,Summit Entertainment,48,Rotten,243,Upright,333701,49,116,127
152,Star Wars: Episode I - The Phantom Menace,64820970,431088295,366267325,15,2970,21825,19/05/1999,Twentieth Century Fox,53,Rotten,223,Spilled,1207697,63,119,104
153,Madagascar: Escape 2 Africa,63106589,180010950,116904361,35.1,4056,15558,7/11/2008,DreamWorks,64,Fresh,155,Upright,366134,38,99,56
154,Pirates of the Caribbean: Dead Men Tell No Tales,62983253,172558876,109575623,36.5,4276,14729,26/05/2017,Walt Disney Studios Motion Pictures,30,Rotten,276,Upright,130425,42,82,194
156,Inception,62785337,292576195,229790858,21.5,3792,16557,16/07/2010,Warner Bros.,87,Certified Fresh,351,Upright,569611,61,304,47
157,Hancock,62603879,227946274,165342395,27.5,3965,15789,2/7/2008,Sony Pictures Releasing,41,Rotten,224,Spilled,556991,49,92,132
158,"Monsters, Inc.",62577067,255873250,193296183,24.5,3237,19331,2/11/2001,Walt Disney Studios Motion Pictures,96,Certified Fresh,195,Upright,1254638,46,187,8
159,Sherlock Holmes,62304277,209028679,146724402,29.8,3626,17182,25/12/2009,Warner Bros.,69,Fresh,242,Upright,769180,52,168,74
161,Fantastic Beasts: The Crimes of Grindelwald,62163104,159555901,97392797,39,4163,14932,16/11/2018,Warner Bros.,37,Rotten,311,Spilled,14437,39,114,197
162,Hulk,62128420,132177234,70048814,47,3660,16974,20/06/2003,Universal Pictures,62,Fresh,233,Spilled,428868,48,144,89
163,The Lord of the Rings: The Two Towers,62007528,339789881,277782353,18.2,3622,17119,18/12/2002,New Line Cinema,95,Certified Fresh,252,Upright,1341428,50,240,12
164,The Amazing Spider-Man,62004688,262030663,200025975,23.7,4318,14359,3/7/2012,Sony Pictures Releasing,72,Certified Fresh,325,Upright,815218,54,235,90
165,Mission: Impossible - Fallout,61236534,220159104,158922570,27.8,4386,13961,27/07/2018,Paramount Pictures,97,Certified Fresh,413,Upright,15266,56,401,12
166,Clash of the Titans,61235105,163214888,101979783,37.5,3777,16212,2/4/2010,Warner Bros.,68,Fresh,41,Upright,56796,3,28,13
167,Kong: Skull Island,61025472,168052812,107027340,36.3,3846,15867,10/3/2017,Warner Bros.,75,Certified Fresh,370,Upright,53985,50,278,92
168,Madagascar 3: Europe's Most Wanted,60316738,216391482,156074744,27.9,4258,14165,8/6/2012,DreamWorks,79,Certified Fresh,131,Upright,256494,32,103,28
169,Kung Fu Panda,60239130,215434591,155195461,28,4114,14642,6/6/2008,DreamWorks,87,Certified Fresh,185,Upright,585078,44,161,24
170,Straight Outta Compton,60200180,161197785,100997605,37.4,2757,21835,14/08/2015,Universal Pictures,88,Certified Fresh,237,Upright,75722,50,209,28
171,Cars,60119509,244082982,183963473,24.6,3985,15086,9/6/2006,Walt Disney Studios Motion Pictures,75,Certified Fresh,200,Upright,877830,48,149,51
172,Signs,60117080,227966634,167849554,26.4,3264,18418,2/8/2002,Walt Disney Studios Motion Pictures,73,Certified Fresh,233,Upright,921131,46,171,62
173,Fast & Furious Presents: Hobbs & Shaw,60038950,173956935,113917985,34.5,4253,14116,2/8/2019,Universal Pictures,67,Fresh,320,Upright,27664,44,214,106
174,Monsters vs. Aliens,59321095,198351526,139030431,29.9,4104,14454,27/03/2009,DreamWorks,73,Fresh,216,Spilled,590311,50,158,58
175,Star Trek Beyond,59253211,158848340,99595129,37.3,3928,15084,22/07/2016,Paramount Pictures,86,Certified Fresh,300,Upright,74283,53,257,43
176,Jason Bourne,59215365,162434410,103219045,36.4,4026,14708,29/07/2016,Universal Pictures,55,Rotten,314,Spilled,56744,53,172,142
178,Pearl Harbor,59078912,198542554,139463642,29.8,3214,18381,25/05/2001,Walt Disney Studios Motion Pictures,24,Rotten,192,Upright,905352,51,47,145
179,Hannibal,58003121,165092268,107089147,35.1,3230,17957,9/2/2001,Metro-Goldwyn-Mayer (MGM),39,Rotten,171,Upright,403002,44,67,104
182,Ant-Man,57225526,180202163,122976637,31.8,3856,14840,17/07/2015,Walt Disney Studios Motion Pictures,83,Certified Fresh,313,Upright,166198,54,260,53
184,22 Jump Street,57071445,191719337,134647892,29.8,3306,17262,13/06/2014,Sony Pictures Releasing,84,Certified Fresh,218,Upright,170296,53,184,34
185,Sex and the City,57038404,152647258,95608854,37.4,3285,17363,30/05/2008,Warner Bros.,49,Rotten,180,Upright,463849,48,89,91
186,John Wick: Chapter 3 - Parabellum,56818067,171015687,114197620,33.2,3850,14757,17/05/2019,Lionsgate,90,Certified Fresh,322,Upright,36923,41,289,33
187,Moana,56631401,248757044,192125643,22.8,3875,14614,23/11/2016,Walt Disney Studios Motion Pictures,96,Certified Fresh,271,Upright,68949,48,259,12
188,Despicable Me,56397125,251513985,195116860,22.4,3476,16224,9/7/2010,Universal Pictures,81,Certified Fresh,197,Upright,267208,40,160,37
189,War for the Planet of the Apes,56262929,146880162,90617233,38.3,4022,13988,14/07/2017,Twentieth Century Fox,94,Certified Fresh,342,Upright,56601,47,320,22
190,Valentine's Day,56260707,110485654,54224947,50.9,3665,15350,12/2/2010,Warner Bros.,18,Rotten,188,Spilled,287229,44,33,155
191,Ralph Breaks the Internet,56237634,201091711,144854077,28,4017,13999,21/11/2018,Walt Disney Studios Motion Pictures,88,Certified Fresh,264,Upright,8083,41,233,31
192,Snow White and the Huntsman,56217700,155332381,99114681,36.2,3773,14900,1/6/2012,Universal Pictures,49,Rotten,232,Spilled,410054,49,114,118
193,Big Hero 6,56215889,222527828,166311939,25.3,3761,14947,7/11/2014,Walt Disney Studios Motion Pictures,89,Certified Fresh,219,Upright,129162,47,195,24
194,Charlie and the Chocolate Factory,56178450,206459076,150280626,27.2,3770,14901,15/07/2005,Warner Bros.,83,Certified Fresh,229,Spilled,32495606,48,189,40
195,Fantastic Four,56061504,154696080,98634576,36.2,3602,15563,8/7/2005,Twentieth Century Fox,27,Rotten,211,Spilled,759102,42,57,154
196,Gravity,55785112,274092705,218307593,20.4,3575,15604,4/10/2013,Warner Bros.,96,Certified Fresh,346,Upright,302684,61,331,15
197,The Karate Kid,55665805,176591618,120925813,31.5,3663,15196,11/6/2010,Sony Pictures Releasing,88,Certified Fresh,43,Upright,316241,6,38,5
198,The Incredible Hulk,55414050,134806913,79392863,41.1,3505,15810,13/06/2008,Universal Pictures,67,Fresh,230,Upright,738941,47,154,76
200,The SpongeBob Movie: Sponge Out of Water,55365012,162994032,107629020,34,3641,15205,6/2/2015,Paramount Pictures,81,Certified Fresh,103,Spilled,51850,32,83,20
201,Watchmen,55214334,107509799,52295465,51.4,3611,15290,6/3/2009,Warner Bros.,64,Fresh,306,Upright,1056931,60,197,109
202,X-Men: First Class,55101604,146408305,91306701,37.6,3641,15133,3/6/2011,Twentieth Century Fox,86,Certified Fresh,290,Upright,184330,53,250,40
203,How the Grinch Stole Christmas,55082330,260044825,204962495,21.2,3127,17615,17/11/2000,Universal Pictures,100,Fresh,25,Upright,26,5,25,0
204,The Chronicles of Narnia: Prince Caspian,55034805,141621490,86586685,38.9,3929,14007,16/05/2008,Walt Disney Studios Motion Pictures,66,Fresh,190,Upright,552816,45,126,64
205,How to Train Your Dragon: The Hidden World,55022245,160799505,105777260,34.2,4259,12919,22/02/2019,Universal Pictures,91,Certified Fresh,248,Upright,55680,34,225,23
206,Rise of the Planet of the Apes,54806191,176760185,121953994,31,3648,15023,5/8/2011,Twentieth Century Fox,82,Certified Fresh,267,Upright,448951,52,218,49
207,The Hobbit: The Battle of the Five Armies,54724334,255119788,200395454,21.4,3875,14122,17/12/2014,Warner Bros.,59,Rotten,254,Upright,214805,50,150,104
208,G.I. Joe: The Rise of Cobra,54713046,150201498,95488452,36.4,4007,13654,7/8/2009,Paramount Pictures,34,Rotten,166,Spilled,995900,35,57,109
209,Divergent,54607747,150947895,96340148,36.2,3936,13873,21/03/2014,Lionsgate,42,Rotten,227,Upright,139716,49,95,132
210,San Andreas,54588173,155190832,100602659,35.2,3777,14452,29/05/2015,Warner Bros.,50,Rotten,239,Spilled,65961,48,120,119
212,X-Men,54471475,157299718,102828243,34.6,3025,18007,14/07/2000,Twentieth Century Fox,81,Certified Fresh,172,Upright,1067514,40,140,32
213,Ted,54415205,218815487,164400282,24.9,3239,16800,29/06/2012,Universal Pictures,68,Fresh,214,Upright,375229,45,146,68
214,Pokémon Detective Pikachu,54365242,144105346,89740104,37.7,4202,12937,10/5/2019,Warner Bros.,68,Fresh,287,Upright,15536,34,195,92
215,The Martian,54308575,228433663,174125088,23.8,3831,14176,2/10/2015,Twentieth Century Fox,91,Certified Fresh,361,Upright,131093,58,330,31
216,Scooby-Doo,54155312,153294164,99138852,35.3,3447,15710,14/06/2002,Warner Bros.,30,Rotten,144,Spilled,408580,32,43,101
218,The Nun,53807379,117450119,63642740,45.8,3876,13882,7/9/2018,Warner Bros.,26,Rotten,191,Spilled,6666,23,49,142
219,Cars 3,53688680,152901115,99212435,35.1,4256,12614,16/06/2017,Walt Disney Studios Motion Pictures,69,Fresh,223,Upright,27101,39,154,69
220,Shazam!,53505326,140371656,86866330,38.1,4217,12688,5/4/2019,Warner Bros.,90,Certified Fresh,383,Upright,15256,44,345,38
221,Green Lantern,53174303,116601172,63426869,45.6,3816,13934,17/06/2011,Warner Bros.,26,Rotten,240,Spilled,149152,48,62,178
222,The Wolverine,53113752,132556852,79443100,40.1,3924,13535,26/07/2013,Twentieth Century Fox,71,Fresh,255,Upright,253171,50,181,74
223,The Lego Batman Movie,53003468,175750384,122746916,30.2,4088,12965,10/2/2017,Warner Bros.,89,Certified Fresh,304,Upright,46206,56,272,32
224,Batman Forever,52784433,184031112,131246679,28.7,2842,18572,16/06/1995,Warner Bros.,39,Rotten,66,Spilled,608810,18,26,40
225,Paranormal Activity 3,52568183,104028807,51460624,50.5,3321,15829,21/10/2011,Paramount Pictures,67,Fresh,124,Spilled,74694,24,83,41
226,Superman Returns,52535096,200081192,147546096,26.3,4065,12923,28/06/2006,Warner Bros.,75,Certified Fresh,263,Upright,516925,52,197,66
227,The Bourne Supremacy,52521865,176241941,123720076,29.8,3165,16594,23/07/2004,Universal Pictures,81,Certified Fresh,194,Upright,708619,44,158,36
228,Insurgent,52263680,130179072,77915392,40.2,3875,13487,20/03/2015,Lionsgate,28,Rotten,200,Spilled,76479,48,56,144
229,"I, Robot",52179887,144801023,92621136,36,3420,15257,16/07/2004,Twentieth Century Fox,56,Rotten,222,Upright,998644,48,125,97
230,Men in Black II,52148751,190418803,138270052,27.4,3557,14660,3/7/2002,Sony Pictures Releasing,39,Rotten,197,Spilled,925896,40,76,121
231,Home,52107731,177397510,125289779,29.4,3708,14052,27/03/2015,Twentieth Century Fox,38,Rotten,8,Spilled,367,4,3,5
232,Van Helsing,51748040,120177084,68429044,43.1,3575,14474,7/5/2004,Universal Pictures,24,Rotten,224,Spilled,608934,43,53,171
233,8 Mile,51240555,116750901,65510346,43.9,2470,20745,8/11/2002,Universal Pictures,75,Certified Fresh,213,Spilled,32167884,53,160,53
234,Men in Black,51068455,250690539,199622084,20.4,3020,16910,2/7/1997,Sony Pictures Releasing,92,Certified Fresh,88,Upright,1049123,27,81,7
235,Bohemian Rhapsody,51061119,216428042,165366923,23.6,4000,12765,2/11/2018,Twentieth Century Fox,61,Fresh,386,Upright,22309,41,234,152
236,Prometheus,51050101,126477084,75426983,40.4,3396,15032,8/6/2012,Twentieth Century Fox,73,Certified Fresh,300,Upright,262879,56,220,80
237,Wanted,50927085,134508551,83581466,37.9,3175,16040,27/06/2008,Universal Pictures,71,Certified Fresh,204,Upright,1546021,45,145,59
238,Coco,50802605,209726015,158923410,24.2,3987,12742,22/11/2017,Walt Disney Studios Motion Pictures,97,Certified Fresh,330,Upright,26889,50,321,9
239,Jurassic Park III,50771645,181171875,130400230,28,3434,14784,18/07/2001,Universal Pictures,49,Rotten,181,Spilled,526557,40,88,93
240,The Village,50746142,114197520,63451378,44.4,3730,13604,30/07/2004,Walt Disney Studios Motion Pictures,44,Rotten,216,Spilled,454044,45,94,122
241,Dunkirk,50513488,188045546,137532058,26.9,3720,13578,21/07/2017,Warner Bros.,92,Certified Fresh,439,Upright,67622,57,406,33
242,2 Fast 2 Furious,50472480,127154901,76682421,39.7,3408,14810,6/6/2003,Universal Pictures,36,Rotten,159,Spilled,32791717,39,58,101
243,Mr. & Mrs. Smith,50342878,186336279,135993401,27,3424,14702,10/6/2005,Twentieth Century Fox,67,Fresh,21,Spilled,4825,5,14,7
245,Rush Hour 3,50237000,140125968,89888968,35.8,3778,13297,10/8/2007,New Line Cinema,18,Rotten,157,Upright,582437,39,28,129
246,Independence Day,50228264,306169268,255941004,16.4,2882,17428,3/7/1996,Twentieth Century Fox,65,Fresh,71,Upright,977377,22,46,25
247,A Quiet Place,50203562,188024361,137820799,26.7,3508,14311,6/4/2018,Paramount Pictures,95,Certified Fresh,364,Upright,21888,46,347,17
248,The Boss Baby,50198902,175003033,124804131,28.7,3773,13304,31/03/2017,Twentieth Century Fox,52,Rotten,177,Spilled,29606,32,92,85
249,King Kong,50130145,218080025,167949880,23,3568,14049,14/12/2005,Universal Pictures,98,Certified Fresh,60,Upright,90052,12,59,1
250,The Great Gatsby,50085185,144840419,94755234,34.6,3535,14168,10/5/2013,Warner Bros.,39,Rotten,36,Spilled,20753,7,14,22
251,Scary Movie 3,49700000,110003217,60303217,45.2,3505,14179,24/10/2003,Dimension Films,35,Rotten,131,Spilled,804280,36,46,85
252,Taken 2,49514769,139854287,90339518,35.4,3661,13524,5/10/2012,Twentieth Century Fox,22,Rotten,169,Spilled,212311,39,37,132
253,How to Train Your Dragon 2,49451322,177002924,127551602,27.9,4253,11627,13/06/2014,Twentieth Century Fox,92,Certified Fresh,180,Upright,188298,43,165,15
254,Neighbors,49033915,150157400,101123485,32.7,3279,14953,9/5/2014,Universal Pictures,63,Fresh,8,Spilled,5909,1,5,3
256,Alvin and the Chipmunks: The Squeakquel,48875415,219614612,170739197,22.3,3700,13209,23/12/2009,Twentieth Century Fox,20,Rotten,84,Spilled,368581,27,17,67
257,Tangled,48767052,200821936,152054884,24.3,3603,13535,24/11/2010,Walt Disney Studios Motion Pictures,89,Certified Fresh,224,Upright,150283,47,200,24
258,Batman Begins,48745440,205343774,156598334,23.7,3858,12634,15/06/2005,Warner Bros.,84,Certified Fresh,279,Upright,1114302,54,235,44
259,The Matrix Revolutions,48475154,139313948,90838794,34.8,3502,13842,5/11/2003,Warner Bros.,35,Rotten,215,Upright,791907,41,76,139
260,Hotel Transylvania 2,48464322,169700110,121235788,28.6,3754,12910,25/09/2015,Sony Pictures Releasing,56,Rotten,106,Upright,89722,24,59,47
261,Godzilla: King of the Monsters,47776293,110500138,62723845,43.2,4108,11630,31/05/2019,Warner Bros.,41,Rotten,323,Upright,25195,37,133,190
263,Mission: Impossible III,47743273,134029801,86286528,35.6,4054,11776,5/5/2006,Paramount Pictures,70,Fresh,221,Upright,508783,51,155,66
264,Kung Fu Panda 2,47656302,165249063,117592761,28.8,3925,12141,26/05/2011,DreamWorks,81,Certified Fresh,177,Upright,145245,41,143,34
266,The Longest Yard,47606480,158119460,110512980,30.1,3634,13100,27/05/2005,Paramount Pictures,81,Fresh,32,Upright,81321,5,26,6
267,Shark Tale,47604606,160861908,113257302,29.6,4016,11853,1/10/2004,DreamWorks Distribution,36,Rotten,183,Spilled,682728,39,65,118
268,Interstellar,47510360,188020017,140509657,25.3,3561,13341,5/11/2014,Paramount Pictures,72,Certified Fresh,350,Upright,174493,58,252,98
269,Madagascar,47224594,193595521,146370927,24.4,4131,11431,27/05/2005,DreamWorks Distribution,54,Rotten,191,Upright,86,45,104,87
270,The Lord of the Rings: The Fellowship of the Ring,47211490,313364114,266152624,15.1,3359,14055,19/12/2001,New Line Cinema,91,Certified Fresh,229,Upright,1355751,49,209,20
271,Die Another Day,47072040,160942139,113870099,29.2,3314,14203,22/11/2002,Metro-Goldwyn-Mayer (MGM),57,Rotten,216,Spilled,430161,47,124,92
272,Talladega Nights: The Ballad of Ricky Bobby,47042215,148213377,101171162,31.7,3803,12369,4/8/2006,Sony Pictures Releasing,71,Certified Fresh,186,Upright,554366,47,132,54
273,Ratatouille,47027395,206445654,159418259,22.8,3940,11935,29/06/2007,Walt Disney Studios Motion Pictures,96,Certified Fresh,249,Upright,1071863,52,238,11
274,Jurassic Park,47026828,357067947,310041119,13.2,2404,19561,11/6/1993,Universal Pictures,91,Certified Fresh,124,Upright,1070290,31,113,11
275,Troy,46865412,133378256,86512844,35.1,3411,13739,14/05/2004,Warner Bros.,54,Rotten,228,Upright,824907,49,122,106
276,The Secret Life of Pets 2,46652680,158874395,112221715,29.4,4561,10228,7/6/2019,Universal Pictures,59,Rotten,151,Upright,21927,21,89,62
277,Pirates of the Caribbean: The Curse of the Black Pearl,46630690,305413918,258783228,15.3,3269,14264,9/7/2003,Walt Disney Studios Motion Pictures,79,Certified Fresh,217,Upright,33125722,45,172,45
278,Ice Age: Continental Drift,46629259,161321843,114692584,28.9,3881,12014,13/07/2012,Twentieth Century Fox,37,Rotten,134,Upright,151201,31,50,84
279,Fifty Shades Darker,46607250,114581250,67974000,40.7,3710,12562,10/2/2017,Universal Pictures,11,Rotten,195,Spilled,27486,44,22,173
280,Trolls,46581142,153707064,107125922,30.3,4060,11473,4/11/2016,Twentieth Century Fox,76,Certified Fresh,160,Upright,38774,33,121,39
281,Bad Boys II,46522560,138608444,92085884,33.6,3186,14602,18/07/2003,Sony Pictures Releasing,22,Rotten,181,Upright,501580,48,40,141
282,Ice Age,46312454,176387405,130074951,26.3,3316,13966,15/03/2002,Twentieth Century Fox,77,Certified Fresh,166,Upright,1134717,39,128,38
283,Angels & Demons,46204168,133375846,87171678,34.6,3527,13100,15/05/2009,Sony Pictures Releasing,36,Rotten,258,Spilled,531659,55,94,164
284,Meet the Fockers,46120980,279261160,233140180,16.5,3518,13110,22/12/2004,Universal Pictures,39,Rotten,162,Spilled,33181885,42,63,99
285,Ghostbusters,46018755,128350574,82331819,35.8,3963,11612,15/07/2016,Sony Pictures Releasing,74,Certified Fresh,375,Spilled,119037,57,279,96
286,Megamind,46016833,148415853,102399020,31,3944,11667,5/11/2010,DreamWorks,72,Fresh,178,Upright,208449,42,128,50
287,Dumbo,45990748,114766307,68775559,40.1,4259,10798,29/03/2019,Walt Disney Studios Motion Pictures,98,Certified Fresh,41,Upright,432138,6,40,1
288,Mission: Impossible,45436830,180981856,135545026,25.1,3012,15085,22/05/1996,Paramount Pictures,63,Fresh,57,Upright,867099,21,36,21
290,Mad Max: Fury Road,45428128,153636354,108208226,29.6,3702,12271,15/05/2015,Warner Bros.,97,Certified Fresh,410,Upright,127428,56,396,14
291,The Meg,45402195,145443742,100041547,31.2,4118,11025,10/8/2018,Warner Bros.,46,Rotten,288,Spilled,6515,41,132,156
292,Ghost Rider,45388836,115802596,70413760,39.2,3619,12541,16/02/2007,Sony Pictures Releasing,26,Rotten,140,Spilled,730783,29,37,103
293,American Pie 2,45117985,145103595,99985610,31.1,3063,14729,10/8/2001,Universal Pictures,52,Rotten,127,Upright,954881,35,66,61
294,300: Rise of an Empire,45038460,106580051,61541591,42.3,3470,12979,7/3/2014,Warner Bros.,45,Rotten,192,Spilled,140422,37,86,106
295,The Hangover,44979319,277322503,232343184,16.2,3269,13759,5/6/2009,Warner Bros.,78,Certified Fresh,238,Upright,942870,48,186,52
297,National Treasure: Book of Secrets,44783772,219964115,175180343,20.4,3832,11686,21/12/2007,Walt Disney Studios Motion Pictures,36,Rotten,129,Upright,1438922,30,47,82
298,Transformers: The Last Knight,44680073,130168683,85488610,34.3,4069,10980,21/06/2017,Paramount Pictures,15,Rotten,244,Spilled,39577,40,36,208
299,Alvin and the Chipmunks,44307417,217326974,173019557,20.4,3475,12750,14/12/2007,Twentieth Century Fox,28,Rotten,109,Upright,310645,34,30,79
301,The Peanuts Movie,44213073,130178411,85965338,34,3897,11345,6/11/2015,Twentieth Century Fox,87,Certified Fresh,193,Upright,66964,43,168,25
302,Hotel Transylvania 3: Summer Vacation,44076225,167510016,123433791,26.3,4267,10329,13/07/2018,Sony Pictures Releasing,62,Fresh,115,Spilled,3325,23,71,44
303,Godzilla,44047541,136314294,92266753,32.3,3310,13307,20/05/1998,Sony Pictures Releasing,16,Rotten,76,Spilled,302817,12,12,64
304,Lucy,43899340,126663600,82764260,34.7,3173,13835,25/07/2014,Universal Pictures,67,Fresh,230,Spilled,135023,49,154,76
307,How to Train Your Dragon,43732319,217581231,173848912,20.1,4055,10784,26/03/2010,DreamWorks,99,Certified Fresh,208,Upright,312342,45,205,3
308,Noah,43720472,101200044,57479572,43.2,3567,12256,28/03/2014,Paramount Pictures,76,Certified Fresh,256,Spilled,122124,53,194,62
309,The Croods,43639736,187168425,143528689,23.3,4046,10785,22/03/2013,Twentieth Century Fox,71,Fresh,142,Upright,193562,36,101,41
310,American Gangster,43565135,130164645,86599510,33.5,3054,14264,2/11/2007,Universal Pictures,80,Certified Fresh,214,Upright,963034,54,172,42
311,The Mummy,43369635,155385488,112015853,27.9,3210,13510,7/5/1999,Universal Pictures,93,Fresh,28,Upright,12279,5,26,2
312,Hitch,43142214,179495555,136353341,24,3575,12067,11/2/2005,Sony Pictures Releasing,68,Fresh,183,Upright,32624083,38,124,59
313,A Star Is Born,42908051,215288866,172380815,19.9,3686,11640,5/10/2018,Warner Bros.,100,Fresh,20,Upright,2667,5,20,0
314,Batman & Robin,42872605,107325195,64452590,40,2934,14612,20/06/1997,Warner Bros.,11,Rotten,89,Spilled,554057,29,10,79
315,Terminator Salvation,42558390,125322469,82764079,34,3530,12056,21/05/2009,Warner Bros.,33,Rotten,277,Spilled,884728,52,92,185
316,Hotel Transylvania,42522194,148313048,105790854,28.7,3349,12696,28/09/2012,Sony Pictures Releasing,44,Rotten,144,Upright,151218,33,64,80
317,Nutty Professor II: The Klumps,42518830,123309890,80791060,34.5,3242,13115,28/07/2000,Universal Pictures,26,Rotten,88,Spilled,231609,24,23,65
318,Shrek,42347760,267665011,225317251,15.8,3587,11805,16/05/2001,DreamWorks Distribution,88,Certified Fresh,204,Upright,1378744,49,179,25
319,Scary Movie,42346669,157019771,114673102,27,2912,14542,7/7/2000,Miramax,53,Rotten,116,Spilled,32582014,32,61,55
320,Anger Management,42220847,135645823,93424976,31.1,3551,11889,11/4/2003,Revolution Studios,42,Rotten,193,Upright,745776,46,82,111
321,The Conjuring,41855326,137400141,95544815,30.5,2903,14417,19/07/2013,Warner Bros.,85,Certified Fresh,218,Upright,158920,48,186,32
323,Ready Player One,41764050,137690172,95926122,30.3,4234,9863,29/03/2018,Warner Bros.,72,Certified Fresh,416,Upright,24505,53,301,115
324,The Hangover Part III,41671198,112200072,70528874,37.1,3555,11721,23/05/2013,Warner Bros.,20,Rotten,203,Spilled,165681,41,41,162
326,Big Daddy,41536370,163479795,121943425,25.4,3027,13721,25/06/1999,Sony Pictures Releasing,40,Rotten,93,Upright,1052103,27,37,56
328,Happy Feet,41533432,198000317,156466885,21,3804,10918,17/11/2006,Warner Bros.,76,Certified Fresh,166,Upright,617295,45,126,40
329,Ride Along,41516170,134938200,93422030,30.8,2663,15590,17/01/2014,Universal Pictures,18,Rotten,132,Spilled,99045,43,24,108
330,Grown Ups 2,41508572,133668525,92159953,31,3491,11890,12/7/2013,Sony Pictures Releasing,7,Rotten,112,Spilled,180859,30,8,104
331,The Perfect Storm,41325042,182618434,141293392,22.6,3407,12129,30/06/2000,Warner Bros.,47,Rotten,135,Upright,279150,30,63,72
332,Kung Fu Panda 3,41282042,143528619,102246577,28.8,3955,10437,29/01/2016,Twentieth Century Fox,87,Certified Fresh,173,Upright,99762,39,150,23
333,The Vow,41202458,125014030,83811572,33,2958,13929,10/2/2012,Screen Gems,31,Rotten,134,Upright,127925,33,41,93
334,Deep Impact,41152375,140464664,99312289,29.3,3156,13039,8/5/1998,Paramount Pictures,45,Rotten,86,Spilled,340688,21,39,47
335,Shutter Island,41062440,128012934,86950494,32.1,2991,13728,19/02/2010,Paramount Pictures,68,Fresh,253,Upright,2373625,52,173,80
337,Twister,41059405,241721524,200662119,17,2414,17008,10/5/1996,Warner Bros.,57,Rotten,54,Spilled,894092,13,31,23
338,Independence Day: Resurgence,41039944,103144286,62104342,39.8,4130,9937,24/06/2016,Twentieth Century Fox,29,Rotten,220,Spilled,74934,33,63,157
339,Madea Goes to Jail,41030947,90508336,49477389,45.3,2032,20192,20/02/2009,Lionsgate,27,Rotten,51,Upright,44752,13,14,37
340,Casino Royale,40833156,167445960,126612804,24.4,3434,11890,17/11/2006,Sony Pictures Releasing,26,Rotten,38,Spilled,33148,8,10,28
341,Paranormal Activity 2,40678424,84752907,44074483,48,3216,12648,22/10/2010,Paramount Pictures,59,Rotten,135,Spilled,102941,31,79,56
342,Friday the 13th,40570365,65002019,24431654,62.4,3105,13066,13/02/2009,Warner Bros.,62,Fresh,52,Upright,228895,6,32,20
343,Grown Ups,40506562,162001186,121494624,25,3534,11461,25/06/2010,Sony Pictures Releasing,10,Rotten,166,Upright,270679,39,16,150
344,G.I. Joe: Retaliation,40501814,122523060,82021246,33.1,3719,10890,28/03/2013,Paramount Pictures,29,Rotten,173,Spilled,199061,38,50,123
345,The Mummy: Tomb of the Dragon Emperor,40457770,102491776,62034006,39.5,3760,10760,1/8/2008,Universal Pictures,13,Rotten,175,Spilled,340517,46,22,153
347,The Conjuring 2,40406314,102470008,62063694,39.4,3343,12086,10/6/2016,Warner Bros.,80,Certified Fresh,246,Upright,54228,36,198,48
348,Glass,40328920,111048468,70719548,36.3,3841,10499,18/01/2019,Universal Pictures,37,Rotten,368,Upright,11775,46,137,231
349,The Last Airbender,40325019,131772187,91447168,30.6,3169,12724,1/7/2010,Paramount Pictures,5,Rotten,189,Spilled,321915,43,10,179
350,Daredevil,40310419,102543518,62233099,39.3,3471,11613,14/02/2003,Twentieth Century Fox,44,Rotten,226,Spilled,468380,46,99,127
351,Insidious: Chapter 2,40272103,83586447,43314344,48.2,3049,13208,13/09/2013,FilmDistrict,39,Rotten,123,Spilled,91722,30,48,75
353,Scary Movie 4,40222875,90710620,50487745,44.3,3602,11166,14/04/2006,-,35,Rotten,127,Spilled,562290,28,45,82
354,Safe House,40172720,126373434,86200714,31.8,3119,12880,10/2/2012,Universal Pictures,52,Rotten,189,Upright,118576,38,99,90
355,Charlie's Angels,40128550,125305545,85176995,32,3037,13213,3/11/2000,Sony Pictures Releasing,68,Fresh,144,Spilled,729048,37,98,46
356,The Fast and the Furious,40089015,144533925,104444910,27.7,2628,15254,22/06/2001,Universal Pictures,53,Rotten,149,Upright,1043882,37,79,70
357,Cloverfield,40058229,80048433,39990204,50,3411,11743,18/01/2008,Paramount Pictures,77,Certified Fresh,208,Upright,420051,40,160,48
358,Chicken Little,40049778,135386665,95336887,29.6,3654,10960,4/11/2005,Walt Disney Studios Motion Pictures,37,Rotten,162,Spilled,470620,42,60,102
359,Click,40011365,137355633,97344268,29.1,3749,10672,23/06/2006,Revolution Studios,33,Rotten,170,Upright,874657,43,56,114
360,Split,40010975,138291365,98280390,28.9,3038,13170,20/01/2017,Universal Pictures,77,Certified Fresh,294,Upright,53061,51,226,68
361,50 First Dates,39852237,120908074,81055837,33,3591,11097,13/02/2004,Sony Pictures Releasing,45,Rotten,175,Upright,32700188,42,78,97
362,Wild Hogs,39699023,168273550,128574527,23.6,3287,12077,2/3/2007,Walt Disney Studios Motion Pictures,14,Rotten,142,Upright,395692,44,20,122
363,Sherlock Holmes: A Game of Shadows,39637079,186848418,147211339,21.2,3703,10704,16/12/2011,Warner Bros.,60,Fresh,222,Upright,168318,47,133,89
364,The Waterboy,39414071,161491646,122077575,24.4,2664,14795,6/11/1998,Walt Disney Studios Motion Pictures,35,Rotten,75,Upright,910706,18,26,49
365,Rio 2,39327869,131538435,92210566,29.9,3948,9961,11/4/2014,Twentieth Century Fox,48,Rotten,115,Spilled,105607,31,55,60
366,Rio,39225962,143619809,104393847,27.3,3826,10252,15/04/2011,Twentieth Century Fox,72,Fresh,148,Upright,90196,36,106,42
367,Taken 3,39201657,89256424,50054767,43.9,3594,10907,9/1/2015,Twentieth Century Fox,13,Rotten,118,Spilled,67991,29,15,103
368,The Break-Up,39172785,118703275,79530490,33,3070,12759,2/6/2006,Universal Pictures,34,Rotten,191,Spilled,450300,47,65,126
369,The Good Dinosaur,39155217,123087120,83931903,31.8,3749,10444,25/11/2015,Walt Disney Studios Motion Pictures,76,Certified Fresh,213,Upright,58744,39,162,51
370,Ocean's Twelve,39153380,125544280,86390900,31.2,3290,11900,10/12/2004,Warner Bros.,55,Rotten,183,Upright,672785,42,100,83
371,The Grudge,39128715,110359362,71230647,35.5,3245,12058,22/10/2004,Sony Pictures Releasing,39,Rotten,160,Spilled,458612,36,62,98
372,Magic Mike,39127170,113721571,74594401,34.4,2930,13353,29/06/2012,Warner Bros.,80,Certified Fresh,207,Upright,144807,44,166,41
373,The Heat,39115043,159582188,120467145,24.5,3181,12296,28/06/2013,Twentieth Century Fox,64,Fresh,177,Upright,166800,43,114,63
375,Kingsman: The Golden Circle,39023010,100229647,61206637,38.9,4003,9748,22/09/2017,Twentieth Century Fox,52,Rotten,292,Upright,45293,44,151,141
376,Dinosaur,38854851,137748063,98893212,28.2,3257,11929,19/05/2000,Walt Disney Studios Motion Pictures,64,Fresh,123,Spilled,71163,33,79,44
377,Daddy's Home,38740203,150357137,111616934,25.8,3271,11843,25/12/2015,Paramount Pictures,31,Rotten,121,Spilled,43654,29,37,84
378,Get Smart,38683480,130319208,91635728,29.7,3911,9890,20/06/2008,Warner Bros.,50,Rotten,220,Upright,451171,46,111,109
379,Fifty Shades Freed,38560195,100407760,61847565,38.4,3768,10233,9/2/2018,Universal Pictures,12,Rotten,180,Spilled,5624,35,21,159
380,The Legend of Tarzan,38527856,126643061,88115205,30.4,3561,10819,1/7/2016,Warner Bros.,36,Rotten,245,Spilled,58120,49,89,156
382,Over the Hedge,38457003,155019340,116562337,24.8,4059,9474,19/05/2006,DreamWorks,75,Certified Fresh,170,Upright,543658,44,127,43
383,The Angry Birds Movie,38155177,107509366,69354189,35.5,3932,9703,20/05/2016,Sony Pictures Releasing,43,Rotten,157,Spilled,29293,28,68,89
386,The Bourne Legacy,38142825,113203870,75061045,33.7,3745,10185,10/8/2012,Universal Pictures,56,Rotten,225,Spilled,282006,48,126,99
387,Ocean's Eleven,38107822,183417150,145309328,20.8,3075,12392,7/12/2001,Warner Bros.,82,Certified Fresh,173,Upright,32601771,37,142,31
388,Rango,38079323,123477607,85398284,30.8,3917,9721,4/3/2011,Paramount Pictures,88,Certified Fresh,220,Upright,119999,44,193,27
389,Inglourious Basterds,38054676,120540719,82486043,31.6,3165,12023,21/08/2009,The Weinstein Company,89,Certified Fresh,325,Upright,775048,60,288,37
390,Bee Movie,38021044,126631277,88610233,30,3928,9679,2/11/2007,DreamWorks,50,Rotten,173,Spilled,388345,50,87,86
391,Hop,37543710,108085305,70541595,34.7,3579,10490,1/4/2011,Universal Pictures,25,Rotten,136,Spilled,107347,28,34,102
394,Gone Girl,37513109,167767189,130254080,22.4,3014,12446,3/10/2014,Twentieth Century Fox,87,Certified Fresh,348,Upright,127826,63,303,45
395,District 9,37354308,115646235,78291927,32.3,3049,12251,14/08/2009,TriStar Pictures,90,Certified Fresh,311,Upright,1178265,53,279,32
396,Pacific Rim,37285325,101802906,64517581,36.6,3275,11384,12/7/2013,Warner Bros.,72,Fresh,286,Upright,193782,53,205,81
397,Mr. Deeds,37162787,126293452,89130665,29.4,3231,11501,28/06/2002,Sony Pictures Releasing,22,Rotten,155,Spilled,738305,35,34,121
398,Annabelle,37134255,84273813,47139558,44.1,3185,11659,3/10/2014,Warner Bros.,29,Rotten,130,Spilled,49325,28,38,92
399,Air Force One,37132505,172956409,135823904,21.5,2919,12720,25/07/1997,Sony Pictures Releasing,76,Certified Fresh,55,Upright,378783,20,42,13
400,S.W.A.T.,37062535,116934650,79872115,31.7,3202,11574,8/8/2003,Sony Pictures Releasing,47,Rotten,165,Spilled,273520,43,78,87
401,Oblivion,37054485,89107235,52052750,41.6,3783,9795,19/04/2013,Universal Pictures,53,Rotten,250,Upright,163164,46,132,118
402,Red Dragon,36540945,93149898,56608953,39.2,3357,10885,4/10/2002,Universal Pictures,68,Fresh,188,Upright,275418,43,128,60
404,Cowboys & Aliens,36431290,100240551,63809261,36.3,3750,9715,29/07/2011,Universal Pictures,45,Rotten,253,Spilled,104623,50,113,140
405,Freddy vs. Jason,36400000,82622655,46222655,44.1,3014,12076,15/08/2003,New Line Cinema,41,Rotten,158,Spilled,393680,36,65,93
406,Marley & Me,36357586,143153751,106796165,25.4,3480,10447,25/12/2008,Twentieth Century Fox,62,Fresh,139,Upright,264854,42,86,53
408,21 Jump Street,36302612,138447667,102145055,26.2,3121,11631,16/03/2012,Sony Pictures Releasing,85,Certified Fresh,220,Upright,257395,44,186,34
409,Kingsman: The Secret Service,36206331,128261724,92055393,28.2,3204,11300,13/02/2015,Twentieth Century Fox,74,Certified Fresh,251,Upright,125173,50,186,65
410,Jumanji: Welcome to the Jungle,36169328,404515480,368346152,8.9,3765,9606,20/12/2017,Sony Pictures Releasing,76,Certified Fresh,227,Upright,38483,38,173,54
411,Alien: Covenant,36160621,74262031,38101410,48.7,3761,9614,19/05/2017,Twentieth Century Fox,66,Fresh,388,Spilled,63627,54,257,131
412,Ocean's Thirteen,36133403,117154724,81021321,30.8,3565,10135,8/6/2007,Warner Bros.,70,Fresh,197,Upright,1532494,54,138,59
413,Dumb and Dumber To,36111775,86208010,50096235,41.9,3154,11449,14/11/2014,Universal Pictures,30,Rotten,146,Spilled,65641,34,44,102
414,Armageddon,36089972,201578182,165488210,17.9,3127,11541,1/7/1998,Walt Disney Studios Motion Pictures,38,Rotten,121,Upright,909501,36,46,75
415,The Scorpion King,36075875,91047077,54971202,39.6,3444,10474,19/04/2002,Universal Pictures,40,Rotten,136,Spilled,293107,31,55,81
416,Robin Hood,36063385,105269730,69206345,34.3,3503,10295,14/05/2010,Universal Pictures,54,Rotten,28,Upright,271595,6,15,13
417,Robots,36045301,128200012,92154711,28.1,3776,9545,11/3/2005,Twentieth Century Fox,64,Fresh,181,Spilled,241054,39,116,65
418,Salt,36011243,118311368,82300125,30.4,3612,9969,23/07/2010,Sony Pictures Releasing,62,Fresh,242,Spilled,200594,52,151,91
420,Rampage,35753093,101028233,65275140,35.4,4101,8718,13/04/2018,Warner Bros.,51,Rotten,264,Upright,9432,44,135,129
423,Minority Report,35677125,132072926,96395801,27,3001,11888,21/06/2002,Twentieth Century Fox,91,Certified Fresh,249,Upright,481256,53,226,23
424,Sweet Home Alabama,35648740,127223418,91574678,28,3293,10825,27/09/2002,Walt Disney Studios Motion Pictures,38,Rotten,159,Upright,802665,36,61,98
425,The Smurfs,35611637,142614158,107002521,25,3395,10489,29/07/2011,Sony Pictures Releasing,22,Rotten,116,Spilled,70814,30,25,91
426,Creed II,35574710,115715889,80141179,30.7,3441,10338,21/11/2018,Metro-Goldwyn-Mayer (MGM),84,Certified Fresh,283,Upright,5103,43,238,45
427,The Other Guys,35543162,119219978,83676816,29.8,3651,9735,6/8/2010,Sony Pictures Releasing,78,Certified Fresh,203,Upright,160419,43,159,44
429,Central Intelligence,35535250,127440871,91905621,27.9,3508,10129,17/06/2016,Warner Bros.,71,Fresh,184,Upright,54195,41,130,54
430,The World Is Not Enough,35519007,126943684,91424677,28,3163,11229,19/11/1999,Metro-Goldwyn-Mayer (MGM),52,Rotten,139,Spilled,210189,36,72,67
431,Super 8,35451168,127004179,91553011,27.9,3379,10491,10/6/2011,Paramount Pictures,81,Certified Fresh,285,Upright,135134,53,231,54
432,Spider-Man: Into the Spider-Verse,35363376,190241310,154877934,18.6,3813,9274,14/12/2018,Sony Pictures Releasing,97,Certified Fresh,370,Upright,18438,40,360,10
433,Teenage Mutant Ninja Turtles: Out of the Shadows,35316382,82051601,46735219,43,4071,8675,3/6/2016,Paramount Pictures,37,Rotten,169,Spilled,53537,27,62,107
434,Lilo & Stitch,35260212,145794338,110534126,24.2,3191,11049,21/06/2002,Walt Disney Studios Motion Pictures,86,Certified Fresh,146,Upright,466971,36,125,21
435,Sing,35258145,270395425,235137280,13,4022,8766,21/12/2016,Universal Pictures,72,Fresh,180,Upright,39305,33,129,51
436,Ride Along 2,35243095,91221830,55978735,38.6,3175,11100,15/01/2016,Universal Pictures,14,Rotten,116,Spilled,35010,29,16,100
437,National Treasure,35142554,173008894,137866340,20.3,3017,11648,19/11/2004,Walt Disney Studios Motion Pictures,46,Rotten,177,Upright,923959,44,81,96
438,The Ring Two,35065237,76231249,41166012,46,3332,10523,18/03/2005,DreamWorks Distribution,20,Rotten,188,Spilled,400176,40,38,150
439,Runaway Bride,35055556,152257509,117201953,23,3158,11100,30/07/1999,Paramount Pictures,46,Rotten,87,Spilled,437966,28,40,47
440,Sully,35028301,125070033,90041732,28,3525,9937,9/9/2016,Warner Bros.,86,Certified Fresh,334,Upright,48328,51,286,48
441,Annabelle: Creation,35006404,102092201,67085797,34.3,3502,9996,11/8/2017,Warner Bros.,70,Fresh,183,Upright,21777,28,129,54
442,Mamma Mia! Here We Go Again,34952180,120634935,85682755,29,3317,10537,20/07/2018,Universal Pictures,80,Certified Fresh,265,Upright,5062,44,212,53
443,The Expendables,34825135,103068524,68243389,33.8,3270,10649,13/08/2010,Lionsgate,42,Rotten,204,Upright,297269,42,86,118
444,Gladiator,34819017,187705427,152886410,18.6,2938,11851,5/5/2000,DreamWorks Distribution,31,Rotten,13,Upright,9784,6,4,9
445,Scream 3,34713342,89143175,54429833,38.9,3467,10012,4/2/2000,Dimension Films,39,Rotten,121,Spilled,404683,30,47,74
446,The Magnificent Seven,34703397,93432655,58729258,37.1,3674,9445,23/09/2016,Sony Pictures Releasing,88,Certified Fresh,43,Upright,53958,7,38,5
447,Identity Thief,34551025,134506920,99955895,25.7,3141,11000,8/2/2013,Universal Pictures,19,Rotten,174,Spilled,192659,45,33,141
448,Enchanted,34440317,127807262,93366945,27,3730,9233,21/11/2007,Walt Disney Studios Motion Pictures,93,Certified Fresh,190,Upright,407478,47,176,14
450,Couples Retreat,34286740,109204945,74918205,31.4,3000,11428,9/10/2009,Universal Pictures,10,Rotten,162,Spilled,293605,43,17,145
451,Sausage Party,34263534,97685686,63422152,35.1,3103,11042,12/8/2016,Sony Pictures Releasing,83,Certified Fresh,227,Spilled,64632,41,188,39
452,I Now Pronounce You Chuck & Larry,34233750,120059556,85825806,28.5,3495,9795,20/07/2007,Universal Pictures,14,Rotten,157,Upright,1307555,44,22,135
453,Tarzan,34221968,171091819,136869851,20,3005,11388,16/06/1999,Walt Disney Studios Motion Pictures,89,Certified Fresh,105,Upright,370152,28,93,12
454,Ransom,34216088,136492681,102276593,25.1,2676,12786,8/11/1996,Walt Disney Studios Motion Pictures,75,Certified Fresh,72,Upright,119880,23,54,18
455,Norbit,34195434,95673607,61478173,35.7,3136,10904,9/2/2007,DreamWorks,9,Rotten,123,Spilled,660377,36,11,112
456,The Equalizer,34137828,101530738,67392910,33.6,3236,10549,26/09/2014,Sony Pictures Releasing,59,Rotten,197,Upright,91119,43,117,80
457,The Blind Side,34119372,255959475,221840103,13.3,3110,10970,20/11/2009,Warner Bros.,66,Fresh,201,Upright,431681,36,132,69
458,Puss in Boots,34077439,149260504,115183065,22.8,3952,8622,28/10/2011,DreamWorks,85,Certified Fresh,150,Upright,78903,29,128,22
460,The Purge,34058360,64473115,30414755,52.8,2536,13429,7/6/2013,Universal Pictures,39,Rotten,150,Spilled,96461,36,59,91
461,Lethal Weapon 4,34048124,130444603,96396479,26.1,3117,10923,10/7/1998,Warner Bros.,52,Rotten,67,Upright,254565,13,35,32
462,Cloudy with a Chance of Meatballs 2,34017930,119793567,85775637,28.4,4001,8502,27/09/2013,Sony Pictures Releasing,71,Fresh,120,Upright,123841,28,85,35
463,Get Hard,33803253,90411453,56608200,37.4,3175,10646,27/03/2015,Warner Bros.,28,Rotten,181,Spilled,53254,46,50,131
464,The Devil Inside,33732515,53261944,19529429,63.3,2285,14762,6/1/2012,Paramount Pictures,6,Rotten,87,Spilled,45172,19,5,82
465,Think Like a Man,33636303,91547205,57910902,36.7,2015,16692,20/04/2012,Screen Gems,54,Rotten,100,Upright,224251,33,54,46
466,The Proposal,33627598,163958031,130330433,20.5,3056,11003,19/06/2009,Walt Disney Studios Motion Pictures,44,Rotten,187,Upright,860222,44,83,104
467,What Women Want,33614543,182811707,149197164,18.4,3012,11160,15/12/2000,Paramount Pictures,0,Rotten,5,Spilled,350,3,0,5
468,Saw III,33610391,80238724,46628333,41.9,3167,10612,27/10/2006,Lionsgate,29,Rotten,91,Upright,560755,24,26,65
469,Epic,33531068,107518682,73987614,31.2,3882,8637,24/05/2013,Twentieth Century Fox,64,Fresh,126,Upright,101924,28,81,45
470,The Green Hornet,33526876,98780042,65253166,33.9,3584,9354,14/01/2011,Sony Pictures Releasing,44,Rotten,233,Spilled,116318,51,102,131
471,Ted 2,33507870,81476385,47968515,41.1,3442,9735,26/06/2015,Universal Pictures,45,Rotten,203,Spilled,65173,45,92,111
472,101 Dalmatians,33504025,136189294,102685269,24.6,2794,11991,27/11/1996,Walt Disney Studios Motion Pictures,98,Certified Fresh,48,Upright,709186,6,47,1
473,Wrath of the Titans,33457188,83670083,50212895,40,3545,9437,30/03/2012,Warner Bros.,27,Rotten,172,Spilled,158072,35,46,126
474,The Haunting,33435140,91411151,57976011,36.6,2808,11907,23/07/1999,DreamWorks Distribution,87,Fresh,39,Upright,19295,7,34,5
475,Get Out,33377060,176040665,142663605,19,2781,12001,24/02/2017,Universal Pictures,98,Certified Fresh,361,Upright,74059,58,355,6
476,Live Free or Die Hard,33369559,134529403,101159844,24.8,3408,9791,27/06/2007,Twentieth Century Fox,82,Certified Fresh,208,Upright,1859709,50,170,38
477,American Wedding,33369440,104565114,71195674,31.9,3172,10520,1/8/2003,Universal Pictures,54,Rotten,155,Upright,494808,36,83,72
478,Lethal Weapon 3,33243086,144731527,111488441,23,2510,13244,15/05/1992,Warner Bros.,59,Rotten,46,Upright,238769,10,27,19
479,Hustlers,33181361,104963598,71782237,31.6,3250,10209,13/09/2019,STX Entertainment,13,Rotten,16,Spilled,1478,7,2,14
480,A Wrinkle in Time,33123609,100478608,67354999,33,3980,8322,9/3/2018,Walt Disney Studios Motion Pictures,42,Rotten,317,Spilled,8618,51,133,184
481,Superbad,33052411,121463226,88410815,27.2,2948,11211,17/08/2007,Sony Pictures Releasing,87,Certified Fresh,207,Upright,634333,53,181,26
482,Tomorrowland,33028165,93436322,60408157,35.4,3972,8315,22/05/2015,Walt Disney Studios Motion Pictures,50,Rotten,285,Spilled,87687,49,142,143
483,Blades of Glory,33014202,118594548,85580346,27.8,3372,9790,30/03/2007,DreamWorks,70,Fresh,184,Upright,1402970,52,128,56
484,Rush Hour,33001803,141186864,108185061,23.4,2638,12510,18/09/1998,New Line Cinema,60,Fresh,73,Upright,902153,18,44,29
486,Scream 2,32926342,101363301,68436959,32.5,2663,12364,12/12/1997,Dimension Films,82,Certified Fresh,76,Spilled,412433,19,62,14
487,A Nightmare on Elm Street,32902299,63075011,30172712,52.2,3332,9874,30/04/2010,Warner Bros.,94,Certified Fresh,52,Upright,415210,7,49,3
488,The Book of Eli,32789494,94835059,62045565,34.6,3111,10539,15/01/2010,Warner Bros.,47,Rotten,203,Upright,350574,48,95,108
490,Blade Runner 2049,32753122,92054159,59301037,35.6,4058,8071,6/10/2017,Warner Bros.,87,Certified Fresh,425,Upright,59178,52,371,54
491,Where the Wild Things Are,32695407,77233467,44538060,42.3,3735,8753,16/10/2009,Warner Bros.,73,Fresh,268,Spilled,298698,56,195,73
492,Due Date,32689406,100539043,67849637,32.5,3355,9743,5/11/2010,Warner Bros.,40,Rotten,191,Spilled,125381,41,76,115
493,Blade II,32528016,82348319,49820303,39.5,2707,12016,22/03/2002,New Line Cinema,57,Rotten,151,Upright,450699,37,86,65
494,The Maze Runner,32512804,102427862,69915058,31.7,3604,9021,19/09/2014,Twentieth Century Fox,65,Fresh,170,Upright,94206,41,110,60
495,Hannah Montana: The Movie,32324487,79576189,47251702,40.6,3118,10367,10/4/2009,Walt Disney Studios Motion Pictures,43,Rotten,132,Upright,379867,40,57,75
497,Mr. Peabody & Sherman,32207057,111506430,79299373,28.9,3934,8186,7/3/2014,Twentieth Century Fox,81,Certified Fresh,134,Upright,73231,26,108,26
498,Immortals,32206425,83504017,51297592,38.6,3112,10349,11/11/2011,Relativity Media,39,Rotten,128,Spilled,68312,26,50,78
499,Wedding Crashers,32200000,209255921,177055921,15.4,2925,11008,15/07/2005,New Line Cinema,75,Certified Fresh,187,Upright,32961772,48,141,46
500,Elf,32100000,173398518,141298518,18.5,3337,9619,7/11/2003,New Line Cinema,83,Certified Fresh,193,Upright,908669,48,161,32
501,Paul Blart: Mall Cop,31832636,146336178,114503542,21.8,3144,10124,16/01/2009,Sony Pictures Releasing,32,Rotten,114,Spilled,393126,34,37,77
504,Terminator 2: Judgment Day,31765506,204843345,173077839,15.5,2274,13969,3/7/1991,TriStar Pictures,93,Certified Fresh,81,Upright,748320,26,75,6
505,Saw IV,31756764,63300095,31543331,50.2,3183,9976,26/10/2007,Lionsgate,19,Rotten,80,Upright,569248,21,15,65
506,Saw II,31725652,87039965,55314313,36.4,2949,10758,28/10/2005,Lionsgate,37,Rotten,121,Spilled,32524689,30,45,76
507,G-Force,31706934,119436770,87729836,26.6,3697,8576,24/07/2009,Walt Disney Studios Motion Pictures,22,Rotten,126,Spilled,964628,34,28,98
508,The Mummy,31688375,80227895,48539520,39.5,4035,7853,9/6/2017,Universal Pictures,93,Fresh,28,Upright,12279,5,26,2
509,Bad Teacher,31603106,100292856,68689750,31.5,3049,10365,24/06/2011,Sony Pictures Releasing,44,Rotten,187,Spilled,84835,44,83,104
510,The Truman Show,31542121,125618201,94076080,25.1,2315,13625,5/6/1998,Paramount Pictures,94,Certified Fresh,126,Upright,583174,34,119,7
511,The Purge: Election Year,31515110,79213375,47698265,39.8,2796,11271,1/7/2016,Universal Pictures,55,Rotten,154,Spilled,38231,32,85,69
512,The Wolfman,31479235,61979680,30500445,50.8,3222,9770,12/2/2010,Universal Pictures,35,Rotten,217,Spilled,223175,39,75,142
513,Percy Jackson & the Olympians: The Lightning Thief,31236067,88768303,57532236,35.2,3356,9307,12/2/2010,Twentieth Century Fox,49,Rotten,144,Spilled,254287,38,71,73
516,Girls Trip,31201920,115171585,83969665,27.1,2591,12042,21/07/2017,Universal Pictures,91,Certified Fresh,162,Upright,23042,38,147,15
517,Evan Almighty,31192615,100462298,69269683,31,3604,8654,22/06/2007,Universal Pictures,23,Rotten,195,Spilled,839578,49,45,150
518,The Sum of All Fears,31178526,118907036,87728510,26.2,3183,9795,31/05/2002,Paramount Pictures,59,Rotten,173,Spilled,89458,39,102,71
519,Home Alone 2: Lost in New York,31126882,173585516,142458634,17.9,2222,14008,20/11/1992,Twentieth Century Fox,32,Rotten,53,Upright,909290,13,17,36
520,Bringing Down the House,31101026,132716677,101615651,23.4,2801,11103,7/3/2003,Walt Disney Studios Motion Pictures,34,Rotten,149,Spilled,379148,36,50,99
522,Four Christmases,31069826,120146040,89076214,25.9,3310,9386,26/11/2008,Warner Bros.,24,Rotten,144,Spilled,254515,38,35,109
523,Into the Woods,31051923,128002372,96950449,24.3,2440,12726,25/12/2014,Walt Disney Studios Motion Pictures,71,Fresh,216,Spilled,96004,48,154,62
524,Sex and the City 2,31001870,95347692,64345822,32.5,3445,8999,27/05/2010,Warner Bros.,15,Rotten,215,Spilled,324230,46,33,182
527,Step Brothers,30940732,100468793,69528061,30.8,3094,10000,25/07/2008,Sony Pictures Releasing,55,Rotten,204,Upright,365512,49,112,92
528,Little Fockers,30833665,148438600,117604935,20.8,3536,8719,22/12/2010,Universal Pictures,9,Rotten,148,Spilled,133018,39,14,134
529,Star Trek: First Contact,30716131,92027888,61311757,33.4,2812,10923,22/11/1996,Paramount Pictures,93,Certified Fresh,56,Upright,100556,16,52,4
530,Knocked Up,30690990,148768917,118077927,20.6,2871,10690,1/6/2007,Universal Pictures,90,Certified Fresh,250,Upright,2084809,53,224,26
531,The Dukes of Hazzard,30675314,80270227,49594913,38.2,3785,8104,5/8/2005,Warner Bros.,14,Rotten,169,NO,NaN,43,23,146
532,Unbroken,30621445,115637895,85016450,26.5,3131,9780,25/12/2014,Universal Pictures,51,Rotten,227,Upright,53250,48,115,112
533,Saving Private Ryan,30576104,216540909,185964805,14.1,2463,12414,24/07/1998,DreamWorks Distribution,93,Certified Fresh,139,Upright,992700,42,129,10
535,The Pacifier,30552694,113086868,82534174,27,3131,9758,4/3/2005,Walt Disney Studios Motion Pictures,20,Rotten,129,Spilled,388365,39,26,103
536,The Happening,30517109,64506874,33989765,47.3,2986,10220,13/06/2008,Twentieth Century Fox,18,Rotten,179,Spilled,370131,42,32,147
538,Just Go with It,30514732,103028109,72513377,29.6,3548,8600,11/2/2011,Sony Pictures Releasing,19,Rotten,137,Spilled,88473,36,26,111
539,The Day the Earth Stood Still,30480153,79366978,48886825,38.4,3560,8561,12/12/2008,Twentieth Century Fox,95,Certified Fresh,55,Upright,34226,6,52,3
540,Dear John,30468614,80014842,49546228,38.1,2969,10262,5/2/2010,Screen Gems,29,Rotten,135,Spilled,619005,40,39,96
541,John Wick: Chapter 2,30436123,92029184,61593061,33.1,3113,9777,10/2/2017,Lionsgate,89,Certified Fresh,264,Upright,55933,44,235,29
542,Night at the Museum,30433781,250863268,220429487,12.1,3685,8258,22/12/2006,Twentieth Century Fox,42,Rotten,135,Upright,723930,37,57,78
543,Olympus Has Fallen,30373794,98925640,68551846,30.7,3098,9804,22/03/2013,FilmDistrict,49,Rotten,191,Upright,148511,38,94,97
544,Unbreakable,30330771,95011339,64680568,31.9,2708,11200,22/11/2000,Walt Disney Studios Motion Pictures,70,Fresh,169,Upright,290817,38,118,51
545,Maze Runner: The Scorch Trials,30316510,81697192,51380682,37.1,3791,7996,18/09/2015,Twentieth Century Fox,46,Rotten,147,Spilled,62125,29,68,79
546,The Addams Family,30300007,100044905,69744898,30.3,4007,7561,11/10/2019,United Artists Releasing,63,Fresh,46,Upright,315126,8,29,17
548,America's Sweethearts,30181877,93607673,63425796,32.2,3011,10023,20/07/2001,Revolution Studios,32,Rotten,145,Spilled,132389,42,46,99
549,John Carter,30180188,73078100,42897912,41.3,3749,8050,9/3/2012,Walt Disney Studios Motion Pictures,52,Rotten,232,Upright,114504,47,120,112
550,Django Unchained,30122888,162805434,132682546,18.5,3010,10007,25/12/2012,The Weinstein Company,86,Certified Fresh,281,Upright,428344,52,243,38
553,The Best Man Holiday,30107555,70525195,40417640,42.7,2024,14875,15/11/2013,Universal Pictures,72,Fresh,92,Upright,52732,31,66,26
554,Trainwreck,30097040,110212700,80115660,27.3,3158,9530,17/07/2015,Universal Pictures,85,Certified Fresh,274,Upright,69210,50,233,41
555,Prince of Persia: The Sands of Time,30095259,90759676,60664417,33.2,3646,8254,28/05/2010,Walt Disney Studios Motion Pictures,37,Rotten,224,Spilled,436767,43,82,142
556,Lemony Snicket's A Series of Unfortunate Events,30061756,118634549,88572793,25.3,3620,8304,17/12/2004,Paramount Pictures,72,Fresh,162,Upright,485171,39,116,46
558,Sleepy Hollow,30060467,101071502,71011035,29.7,3064,9810,19/11/1999,Paramount Pictures,68,Fresh,127,Upright,606912,32,86,41
559,Panic Room,30056751,96397334,66340583,31.2,3053,9844,29/03/2002,Sony Pictures Releasing,75,Certified Fresh,185,Upright,235765,38,139,46
560,The Exorcism of Emily Rose,30054300,75072454,45018154,40,2981,10081,9/9/2005,Screen Gems,44,Rotten,157,Upright,376498,32,69,88
561,Saw V,30053954,56746769,26692815,53,3060,9821,24/10/2008,Lionsgate,13,Rotten,76,Spilled,239402,18,10,66
562,Catch Me If You Can,30053627,164615351,134561724,18.3,3156,9522,25/12/2002,DreamWorks Distribution,95,Certified Fresh,199,Upright,748577,47,190,9
563,A Christmas Carol,30051075,137855863,107804788,21.8,3683,8159,6/11/2009,Walt Disney Studios Motion Pictures,100,Fresh,12,Upright,56563,0,12,0
564,Madea's Family Reunion,30030661,63257940,33227279,47.5,2194,13687,24/02/2006,Lionsgate,25,Rotten,57,Upright,40200,20,14,43
566,The Purge: Anarchy,29816675,71962800,42146125,41.4,2805,10629,18/07/2014,Universal Pictures,56,Rotten,134,Spilled,67825,27,75,59
567,Elysium,29807393,93050117,63242724,32,3284,9076,9/8/2013,TriStar Pictures,66,Fresh,251,Spilled,162765,55,165,86
568,Hercules,29800263,72688614,42888351,41,3595,8289,25/07/2014,Paramount Pictures,84,Certified Fresh,55,Upright,388724,15,46,9
569,Constantine,29769098,75976178,46207080,39.2,3006,9903,18/02/2005,Warner Bros.,46,Rotten,226,Upright,468257,48,105,121
570,What Lies Beneath,29702959,155464351,125761392,19.1,2813,10559,21/07/2000,DreamWorks Distribution,46,Rotten,125,Spilled,278913,31,58,67
571,The Flintstones,29688730,130531208,100842478,22.7,2498,11885,27/05/1994,Universal Pictures,22,Rotten,45,Spilled,261064,10,10,35
572,Dark Shadows,29685274,79727149,50041875,37.2,3755,7905,11/5/2012,Warner Bros.,36,Rotten,252,Spilled,257264,51,90,162
573,Daddy's Home 2,29651193,104029443,74378250,28.5,3575,8294,10/11/2017,Paramount Pictures,21,Rotten,125,Spilled,14928,24,26,99
574,Creed,29632823,109767581,80134758,27,3404,8705,25/11/2015,Warner Bros.,95,Certified Fresh,296,Upright,75737,53,282,14
575,Insidious: The Last Key,29581355,67745330,38163975,43.7,3116,9493,5/1/2018,Universal Pictures,33,Rotten,104,Spilled,5718,20,34,70
576,Justin Bieber: Never Say Never,29514054,73013910,43499856,40.4,3105,9505,11/2/2011,Paramount Pictures,65,Fresh,106,Upright,62188,35,69,37
577,Scooby-Doo 2: Monsters Unleashed,29438331,84216833,54778502,35,3312,8888,26/03/2004,Warner Bros.,22,Rotten,117,Spilled,207195,30,26,91
579,Indiana Jones and the Last Crusade,29355021,197171806,167816785,14.9,2327,12614,24/05/1989,Paramount Pictures,88,Certified Fresh,69,Upright,768092,14,61,8
580,A.I. Artificial Intelligence,29352630,78616689,49264059,37.3,3242,9053,29/06/2001,Warner Bros.,73,Certified Fresh,192,Upright,413913,46,141,51
581,Now You See Me,29350389,117723989,88373600,24.9,2925,10034,31/05/2013,Lionsgate,50,Rotten,165,Upright,179084,34,83,82
582,Beverly Hills Chihuahua,29300465,94514402,65213937,31,3215,9113,3/10/2008,Walt Disney Studios Motion Pictures,40,Rotten,97,Spilled,186544,30,39,58
583,Think Like a Man Too,29241911,65182182,35940271,44.9,2225,13142,20/06/2014,Screen Gems,22,Rotten,83,Spilled,40168,31,18,65
585,The Muppets,29239026,88631237,59392211,33,3440,8499,23/11/2011,Walt Disney Studios Motion Pictures,95,Certified Fresh,224,Upright,89661,49,212,12
586,The Lone Ranger,29210849,89302115,60091266,32.7,3904,7482,3/7/2013,Walt Disney Studios Motion Pictures,31,Rotten,242,Spilled,137008,48,75,167
587,Eagle Eye,29150721,101440743,72290022,28.7,3510,8305,26/09/2008,DreamWorks,27,Rotten,181,Upright,307302,45,48,133
588,Toy Story,29140617,191796233,162655616,15.2,2457,11860,22/11/1995,Walt Disney Studios Motion Pictures,100,Certified Fresh,88,Upright,1109209,27,88,0
589,The Texas Chainsaw Massacre,29100000,80571655,51471655,36.1,3016,9648,17/10/2003,New Line Cinema,37,Rotten,156,Spilled,400534,39,57,99
590,Spy,29085719,110825712,81739993,26.2,3711,7837,5/6/2015,Twentieth Century Fox,95,Certified Fresh,249,Upright,82669,50,237,12
591,Doctor Dolittle,29014324,144156605,115142281,20.1,2777,10448,26/06/1998,Twentieth Century Fox,32,Rotten,19,Spilled,73371,4,6,13
594,The Santa Clause 2,29008696,139236327,110227631,20.8,3350,8659,1/11/2002,Walt Disney Studios Motion Pictures,55,Rotten,114,Spilled,202429,32,63,51
595,Paranormal Activity 4,29003866,53885000,24881134,53.8,3412,8500,19/10/2012,Paramount Pictures,24,Rotten,110,Spilled,117971,19,26,84
596,Inside Man,28954945,88513495,59558550,32.7,2818,10274,24/03/2006,Universal Pictures,86,Certified Fresh,203,Upright,351339,49,175,28
598,Cast Away,28883406,233632142,204748736,12.4,2774,10412,22/12/2000,Twentieth Century Fox,88,Certified Fresh,156,Upright,743669,37,138,18
599,Non-Stop,28875635,92168600,63292965,31.3,3090,9344,28/02/2014,Universal Pictures,61,Fresh,222,Upright,78455,46,136,86
600,Miss Peregrine's Home for Peculiar Children,28871140,87242834,58371694,33.1,3522,8197,30/09/2016,Twentieth Century Fox,64,Fresh,244,Upright,38751,44,157,87
601,Murder on the Orient Express,28681472,102826543,74145071,27.9,3341,8584,10/11/2017,Twentieth Century Fox,91,Fresh,34,Upright,20790,6,31,3
603,Titanic,28638131,600788188,572150057,4.8,2674,10709,19/12/1997,Paramount Pictures,91,Fresh,11,Upright,86433,0,10,1
604,Meet the Parents,28623300,166244045,137620745,17.2,2614,10950,6/10/2000,Universal Pictures,84,Certified Fresh,148,Upright,1056433,39,124,24
605,Obsessed,28612730,68261644,39648914,41.9,2514,11381,24/04/2009,Screen Gems,19,Rotten,90,Spilled,258477,25,17,73
606,The Expendables 2,28591370,85028192,56436822,33.6,3316,8622,17/08/2012,Lionsgate,68,Fresh,130,Upright,315167,27,88,42
607,Alita: Battle Angel,28525613,85710210,57184597,33.3,3790,7526,14/02/2019,Twentieth Century Fox,61,Fresh,307,Upright,32429,39,186,121
608,Tyler Perry's Boo! A Madea Halloween,28501448,73206343,44704895,38.9,2260,12611,21/10/2016,Lionsgate,19,Rotten,42,Spilled,11980,10,8,34
609,Mama,28402310,71628180,43225870,39.6,2647,10730,18/01/2013,Universal Pictures,64,Fresh,162,Spilled,143726,40,104,58
611,Nacho Libre,28309599,80197993,51888394,35.3,3070,9221,16/06/2006,Paramount Pictures,40,Rotten,164,Spilled,417196,38,65,99
612,Horrible Bosses,28302165,117538559,89236394,24.1,3040,9309,8/7/2011,Warner Bros.,69,Fresh,220,Upright,106578,50,152,68
613,The Invisible Man,28205665,54026015,25820350,52.2,3610,7813,28/02/2020,Universal Pictures,100,Fresh,37,Upright,11089,6,37,0
614,Erin Brockovich,28138465,125595205,97456740,22.4,2848,9880,17/03/2000,Universal Pictures,84,Certified Fresh,145,Upright,418554,38,122,23
615,Starsky & Hutch,28103367,88237754,60134387,31.8,3185,8823,5/3/2004,Warner Bros.,62,Fresh,193,Spilled,383734,47,120,73
617,Sin City,28100000,74103820,46003820,37.9,3230,8699,1/4/2005,Dimension Films,77,Certified Fresh,250,Upright,32222563,50,192,58
618,Back to the Future Part II,27835125,118450002,90614877,23.5,1865,14925,22/11/1989,Universal Pictures,65,Fresh,60,Upright,749814,16,39,21
619,Hairspray,27800000,118871849,91071849,23.4,3121,8907,20/07/2007,New Line Cinema,98,Certified Fresh,42,Upright,64137,9,41,1
620,The Matrix,27788331,171479930,143691599,16.2,2849,9753,31/03/1999,Warner Bros.,88,Certified Fresh,149,Upright,33324202,37,131,18
621,He's Just Not That Into You,27785487,93953653,66168166,29.6,3175,8751,6/2/2009,Warner Bros.,41,Rotten,165,Spilled,433978,51,67,98
622,Mamma Mia!,27751240,144130063,116378823,19.2,2976,9325,18/07/2008,Universal Pictures,54,Rotten,182,Upright,438166,44,99,83
623,Big Momma's House 2,27736056,70165972,42429916,39.5,3261,8505,27/01/2006,Twentieth Century Fox,6,Rotten,72,Spilled,564724,24,4,68
624,Jarhead,27726210,62658220,34932010,44.2,2411,11499,4/11/2005,Universal Pictures,61,Fresh,198,Upright,392719,48,120,78
625,Along Came Polly,27721185,88097164,60375979,31.5,2984,9289,16/01/2004,Universal Pictures,26,Rotten,159,Spilled,463323,40,41,118
626,Wild Wild West,27687484,113804681,86117197,24.3,3342,8284,30/06/1999,Warner Bros.,17,Rotten,131,Spilled,464227,40,22,109
627,Daddy Day Care,27623580,104297061,76673481,26.5,3370,8196,9/5/2003,Revolution Studios,27,Rotten,131,Spilled,472572,39,35,96
628,The Ugly Truth,27605576,88915214,61309638,31,2882,9578,24/07/2009,Sony Pictures Releasing,14,Rotten,173,Upright,1399252,45,24,149
629,Cheaper by the Dozen,27557647,138614544,111056897,19.9,3298,8355,25/12/2003,Twentieth Century Fox,24,Rotten,118,Spilled,723804,34,28,90
630,Wonder,27547866,132422809,104874943,20.8,3096,8897,17/11/2017,Lionsgate,85,Certified Fresh,184,Upright,18658,33,156,28
631,The Devil Wears Prada,27537244,124740460,97203216,22.1,2847,9672,30/06/2006,Twentieth Century Fox,75,Certified Fresh,193,Upright,571693,49,145,48
632,Space Jam,27528529,90418342,62889813,30.4,2650,10388,15/11/1996,Warner Bros.,43,Rotten,75,Upright,655357,22,32,43
633,After Earth,27520040,60522097,33002057,45.5,3401,8091,31/05/2013,Sony Pictures Releasing,11,Rotten,203,Spilled,121821,44,23,180
634,Beowulf,27515871,82280579,54764708,33.4,3153,8726,16/11/2007,Paramount Pictures,0,Rotten,6,Spilled,10358,0,0,6
635,42,27487144,95020213,67533069,28.9,3003,9153,12/4/2013,Warner Bros.,80,Certified Fresh,189,Upright,119509,49,151,38
636,Bedtime Stories,27450296,110101975,82651679,24.9,3681,7457,25/12/2008,Walt Disney Studios Motion Pictures,26,Rotten,110,Spilled,216448,35,29,81
637,The Final Destination,27408309,66477700,39069391,41.2,3121,8781,28/08/2009,Warner Bros.,29,Rotten,98,Spilled,603714,19,28,70
638,Jumper,27354808,80172128,52817320,34.1,3428,7979,14/02/2008,Twentieth Century Fox,15,Rotten,166,Spilled,321296,42,25,141
639,Journey 2: The Mysterious Island,27335363,103860290,76524927,26.3,3470,7877,10/2/2012,Warner Bros.,44,Rotten,131,Spilled,212486,34,58,73
640,The Rugrats Movie,27321470,100494675,73173205,27.2,2782,9820,20/11/1998,Paramount Pictures,59,Rotten,51,Spilled,73658,13,30,21
641,Real Steel,27319677,85468508,58148831,32,3440,7941,7/10/2011,Walt Disney Studios Motion Pictures,60,Fresh,229,Upright,211798,48,138,91
642,Les Misérables,27281735,148809770,121528035,18.3,2814,9695,25/12/2012,Universal Pictures,69,Fresh,248,Upright,265055,46,171,77
643,Night School,27257615,77339130,50081515,35.2,3010,9055,28/09/2018,Universal Pictures,27,Rotten,135,Spilled,2249,29,36,99
644,Jack the Giant Slayer,27202226,65187603,37985377,41.7,3525,7716,1/3/2013,Warner Bros.,53,Rotten,205,Spilled,92495,40,108,97
645,The Bourne Identity,27118640,121661683,94543043,22.3,2638,10280,14/06/2002,Universal Pictures,83,Certified Fresh,189,Upright,965350,42,157,32
646,2 Guns,27059130,75612460,48553330,35.8,3025,8945,2/8/2013,Universal Pictures,64,Fresh,183,Upright,109397,47,118,65
648,Terminator Genisys,27018486,89760956,62742470,30.1,3758,7189,1/7/2015,Paramount Pictures,27,Rotten,258,Spilled,82129,43,69,189
649,Ender's Game,27017351,61737191,34719840,43.8,3407,7929,1/11/2013,Lionsgate,61,Fresh,216,Upright,118421,44,132,84
650,The Departed,26887467,132384315,105496848,20.3,3017,8911,6/10/2006,Warner Bros.,91,Certified Fresh,277,Upright,737217,59,251,26
651,Alice Through the Looking Glass,26858726,77041381,50182655,34.9,3763,7137,27/05/2016,Walt Disney Studios Motion Pictures,29,Rotten,249,Spilled,37749,44,73,176
652,Underworld: Evolution,26857181,62318875,35461694,43.1,3207,8374,20/01/2006,Screen Gems,17,Rotten,103,Upright,567150,23,18,85
653,The Curious Case of Benjamin Button,26853816,127509326,100655510,21.1,2988,8987,25/12/2008,Paramount Pictures,71,Certified Fresh,247,Upright,690447,51,176,71
654,Flubber,26725207,92977226,66252019,28.7,2641,10119,26/11/1997,Walt Disney Studios Motion Pictures,24,Rotten,34,Spilled,623640,8,8,26
657,Dawn of the Dead,26722575,59020957,32298382,45.3,2745,9735,19/03/2004,Universal Pictures,75,Certified Fresh,187,Upright,403866,38,141,46
658,The Sixth Sense,26681262,293506292,266825030,9.1,2161,12346,6/8/1999,Walt Disney Studios Motion Pictures,86,Certified Fresh,153,Upright,1036418,38,131,22
659,Resident Evil: Afterlife,26650264,60128566,33478302,44.3,3203,8320,10/9/2010,Screen Gems,22,Rotten,103,Spilled,128223,15,23,80
660,The House with a Clock in Its Walls,26608020,68549695,41941675,38.8,3592,7407,21/09/2018,Universal Pictures,66,Fresh,208,Spilled,3326,28,137,71
661,The Campaign,26588460,86907746,60319286,30.6,3205,8295,10/8/2012,Warner Bros.,66,Fresh,203,Spilled,123088,45,133,70
662,Spy Kids,26546881,112719001,86172120,23.6,3104,8552,30/03/2001,Miramax,93,Certified Fresh,127,Spilled,427343,30,118,9
663,The Pursuit of Happyness,26541709,163566459,137024750,16.2,2852,9306,15/12/2006,Sony Pictures Releasing,67,Fresh,175,Upright,563231,48,117,58
664,Crazy Rich Asians,26510140,174532921,148022781,15.2,3384,7833,15/08/2018,Warner Bros.,91,Certified Fresh,335,Upright,12083,46,305,30
665,Borat: Cultural Learnings of America for Make Benefit Glorious Nation of Kazakhstan,26455463,128505958,102050495,20.6,837,31607,3/11/2006,Twentieth Century Fox,91,Certified Fresh,219,Upright,1204572,50,199,20
666,All Eyez on Me,26435354,44922302,18486948,58.8,2471,10698,16/06/2017,Lionsgate,18,Rotten,88,Spilled,13897,21,16,72
667,Hollow Man,26414386,73209340,46794954,36.1,2956,8935,4/8/2000,Sony Pictures Releasing,28,Rotten,116,Spilled,366669,31,32,84
669,Don't Breathe,26411706,89217875,62806169,29.6,3051,8656,26/08/2016,Screen Gems,88,Certified Fresh,222,Upright,40340,38,195,27
670,Halloween,26362367,58272029,31909662,45.2,3472,7592,31/08/2007,-,96,Certified Fresh,68,Upright,302801,10,65,3
671,Beverly Hills Cop II,26348555,153665036,127316481,17.2,2326,11327,20/05/1987,Paramount Pictures,46,Rotten,28,Spilled,276170,3,13,15
672,Bridesmaids,26247410,169106725,142859315,15.5,2918,8995,13/05/2011,Universal Pictures,90,Certified Fresh,284,Upright,161459,53,255,29
674,Anchorman 2: The Legend Continues,26232425,125168368,98935943,21,3507,7480,18/12/2013,Paramount Pictures,75,Certified Fresh,200,Spilled,164684,47,149,51
675,Bolt,26223128,114053579,87830451,23,3651,7182,21/11/2008,Walt Disney Studios Motion Pictures,89,Certified Fresh,183,Upright,315167,44,163,20
676,GoldenEye,26205007,106429941,80224934,24.6,2667,9825,17/11/1995,Metro-Goldwyn-Mayer (MGM),77,Certified Fresh,75,Upright,285429,25,58,17
677,The Golden Compass,26125000,70107728,43982728,37.3,3528,7405,7/12/2007,New Line Cinema,42,Rotten,194,Spilled,350530,46,81,113
678,The Help,26044590,169708112,143663522,15.4,2534,10278,10/8/2011,Walt Disney Studios Motion Pictures,76,Certified Fresh,224,Upright,107640,50,170,54
679,Happy Death Day,26039025,55683845,29644820,46.8,3149,8268,13/10/2017,Universal Pictures,71,Fresh,148,Upright,16128,21,105,43
680,The Perfect Guy,25888154,57027435,31139281,45.4,2221,11656,11/9/2015,Screen Gems,18,Rotten,45,Spilled,18625,15,8,37
681,Tropic Thunder,25812796,110515313,84702517,23.4,3319,7777,13/08/2008,DreamWorks,81,Certified Fresh,243,Upright,296463,53,198,45
683,Evil Dead,25775847,54239856,28464009,47.5,3025,8520,5/4/2013,TriStar Pictures,62,Fresh,197,Upright,77183,39,122,75
684,Rocketman,25725722,96368160,70642438,26.7,3610,7126,31/05/2019,Paramount Pictures,89,Certified Fresh,352,Upright,21644,42,314,38
685,Miami Vice,25723815,63450470,37726655,40.5,3021,8515,28/07/2006,Universal Pictures,46,Rotten,221,Spilled,360219,49,102,119
686,Captain Phillips,25718314,107100855,81382541,24,3020,8515,11/10/2013,Sony Pictures Releasing,93,Certified Fresh,268,Upright,152261,55,249,19
687,Fantastic Four,25685737,56117548,30431811,45.8,3995,6429,7/8/2015,Twentieth Century Fox,27,Rotten,211,Spilled,759102,42,57,154
688,The A-Team,25669455,77222099,51552644,33.2,3535,7261,11/6/2010,Twentieth Century Fox,49,Rotten,212,Upright,199293,43,103,109
689,Big Momma's House,25661041,117559438,91898397,21.8,2802,9158,2/6/2000,Twentieth Century Fox,30,Rotten,81,Spilled,475698,26,24,57
690,About Last Night,25649011,48637684,22988673,52.7,2253,11384,14/02/2014,Screen Gems,61,Fresh,28,Spilled,12655,9,17,11
691,V for Vendetta,25642340,70511035,44868695,36.4,3365,7620,17/03/2006,Warner Bros.,72,Certified Fresh,247,Upright,903721,50,179,68
692,Robin Hood: Prince of Thieves,25625602,165493908,139868306,15.5,2369,10817,14/06/1991,Warner Bros.,51,Rotten,53,Upright,334677,14,27,26
693,Total Recall,25577758,58877969,33300211,43.4,3601,7102,3/8/2012,Sony Pictures Releasing,82,Certified Fresh,68,Upright,244422,19,56,12
696,Battleship,25534825,65422625,39887800,39,3690,6920,18/05/2012,Universal Pictures,34,Rotten,221,Spilled,456521,43,76,145
697,Total Recall,25533700,119394840,93861140,21.4,2060,12395,1/6/1990,Sony Pictures Releasing,82,Certified Fresh,68,Upright,244422,19,56,12
698,The Visit,25427560,65206105,39778545,39,3069,8285,11/9/2015,Universal Pictures,67,Fresh,224,Spilled,34689,39,150,74
700,The Nutty Professor,25411725,128814019,103402294,19.7,2115,12015,28/06/1996,Universal Pictures,85,Fresh,26,Upright,32962,0,22,4
701,The Firm,25400000,158348367,132948367,16,2393,10614,2/7/1993,Paramount Pictures,75,Certified Fresh,55,Upright,67852,11,41,14
702,Teenage Mutant Ninja Turtles,25398367,135265915,109867548,18.8,2006,12661,30/03/1990,New Line Cinema,22,Rotten,151,Spilled,131934,41,33,118
703,Madea's Witness Protection,25390575,65653242,40262667,38.7,2161,11749,29/06/2012,Lionsgate,19,Rotten,36,Upright,175894,13,7,29
704,Apollo 13,25353380,172071312,146717932,14.7,2197,11540,30/06/1995,Universal Pictures,95,Certified Fresh,88,Upright,432793,32,84,4
706,Indiana Jones and the Temple of Doom,25337110,179870271,154533161,14.1,1687,15019,23/05/1984,Paramount Pictures,85,Certified Fresh,66,Upright,716416,9,56,10
707,Gone in 60 Seconds,25336048,101648571,76312523,24.9,3006,8428,9/6/2000,Walt Disney Studios Motion Pictures,43,Rotten,14,Upright,196397,1,6,8
708,Public Enemies,25271675,97104620,71832945,26,3334,7579,1/7/2009,Universal Pictures,68,Fresh,276,Spilled,633635,55,187,89
710,Patch Adams,25262280,135026902,109764622,18.7,2712,9315,25/12/1998,Universal Pictures,22,Rotten,68,Upright,265051,23,15,53
711,Date Night,25207599,98711404,73503805,25.5,3374,7471,9/4/2010,Twentieth Century Fox,66,Fresh,228,Spilled,230423,48,151,77
712,Tomorrow Never Dies,25143007,125304276,100161269,20.1,2807,8957,19/12/1997,Metro-Goldwyn-Mayer (MGM),57,Rotten,86,Spilled,230913,25,49,37
713,Meet the Robinsons,25123781,97822171,72698390,25.7,3413,7361,30/03/2007,Walt Disney Studios Motion Pictures,67,Fresh,140,Upright,400053,40,94,46
714,Master and Commander: The Far Side of the World,25105990,93927920,68821930,26.7,3101,8096,14/11/2003,Twentieth Century Fox,85,Certified Fresh,214,Upright,140973,45,181,33
715,The Rock,25069525,134069511,108999986,18.7,2392,10480,7/6/1996,Walt Disney Studios Motion Pictures,66,Fresh,64,Upright,305085,22,42,22
716,Madea's Big Happy Family,25068677,53345287,28276610,47,2288,10956,22/04/2011,Lionsgate,37,Rotten,41,Upright,31105,13,15,26
717,Dr. Dolittle 2,25037039,112952899,87915860,22.2,3049,8211,22/06/2001,Twentieth Century Fox,42,Rotten,106,Spilled,436838,33,44,62
718,Vanilla Sky,25015518,100618344,75602826,24.9,2742,9123,14/12/2001,Paramount Pictures,42,Rotten,170,Upright,297968,37,71,99
719,Peter Rabbit,25010928,115253424,90242496,21.7,3725,6714,9/2/2018,Sony Pictures Releasing,64,Fresh,144,Spilled,3274,25,92,52
720,Jack and Jill,25003575,74158157,49154582,33.7,3438,7272,11/11/2011,Sony Pictures Releasing,3,Rotten,111,Spilled,68618,31,3,108
721,Skyscraper,24905015,68420120,43515105,36.4,3782,6585,13/07/2018,Universal Pictures,47,Rotten,270,Upright,6234,39,128,142
722,Flight,24900566,93772375,68871809,26.6,1884,13216,2/11/2012,Paramount Pictures,77,Certified Fresh,231,Upright,153198,48,179,52
723,White House Down,24852258,73103784,48251526,34,3222,7713,28/06/2013,Sony Pictures Releasing,51,Rotten,199,Upright,127738,44,102,97
724,True Grit,24830443,171243005,146412562,14.5,3047,8149,22/12/2010,Paramount Pictures,88,Certified Fresh,52,Upright,26106,15,46,6
726,The Other Woman,24763752,83911193,59147441,29.5,3205,7726,25/04/2014,Twentieth Century Fox,38,Rotten,45,Spilled,15106,18,17,28
728,Predators,24760882,52000688,27239806,47.6,2669,9277,9/7/2010,Twentieth Century Fox,65,Fresh,198,Spilled,159760,31,129,69
729,Zombieland,24733155,75590286,50857131,32.7,3036,8146,2/10/2009,Sony Pictures Releasing,90,Certified Fresh,249,Upright,642759,46,224,25
730,10 Cloverfield Lane,24727437,72082998,47355561,34.3,3391,7292,11/3/2016,Paramount Pictures,90,Certified Fresh,301,Upright,60607,49,271,30
731,Taken,24717037,145000989,120283952,17,3183,7765,30/01/2009,Twentieth Century Fox,58,Rotten,172,Upright,738761,44,99,73
732,The Accountant,24710273,86260045,61549772,28.6,3332,7416,14/10/2016,Warner Bros.,51,Rotten,274,Upright,46454,51,141,133
733,Collateral,24701458,101005703,76304245,24.5,3188,7748,6/8/2004,DreamWorks Distribution,86,Certified Fresh,234,Upright,364059,49,202,32
734,Congo,24642539,81022101,56379562,30.4,2649,9302,9/6/1995,Paramount Pictures,22,Rotten,49,Spilled,60479,14,11,38
735,Lee Daniels' The Butler,24637312,116632095,91994783,21.1,2933,8400,16/08/2013,The Weinstein Company,72,Fresh,194,Upright,79264,51,139,55
736,The Predator,24632284,51024708,26392424,48.3,4037,6101,14/09/2018,Twentieth Century Fox,32,Rotten,277,Spilled,6711,36,88,189
737,Flightplan,24629938,89707299,65077361,27.5,3424,7193,23/09/2005,Walt Disney Studios Motion Pictures,37,Rotten,177,Spilled,496854,39,65,112
738,Knowing,24604751,79957634,55352883,30.8,3332,7384,20/03/2009,Summit Entertainment,33,Rotten,182,Spilled,431605,35,60,122
739,Christopher Robin,24585139,99215042,74629903,24.8,3602,6825,3/8/2018,Walt Disney Studios Motion Pictures,73,Fresh,263,Upright,5472,42,192,71
740,Eraser,24566446,101295562,76729116,24.2,2410,10193,21/06/1996,Warner Bros.,35,Rotten,48,Spilled,126696,14,17,31
741,The Girl on the Train,24536265,75395035,50858770,32.5,3144,7804,7/10/2016,Universal Pictures,44,Rotten,297,Spilled,34336,54,132,165
742,The Emoji Movie,24531923,86089513,61557590,28.5,4075,6020,28/07/2017,Sony Pictures Releasing,7,Rotten,129,Spilled,24942,23,9,120
743,Pet Sematary,24502775,54724696,30221921,44.8,3585,6834,5/4/2019,Paramount Pictures,50,Rotten,34,Spilled,97713,1,17,17
744,Act of Valor,24476632,70012847,45536215,35,3039,8054,24/02/2012,Relativity Media,26,Rotten,137,Upright,80426,37,36,101
745,Forrest Gump,24450602,329694499,305243897,7.4,1595,15329,6/7/1994,Paramount Pictures,72,Fresh,98,Upright,1244237,28,71,27
746,Mean Girls,24432195,86058055,61625860,28.4,2839,8605,30/04/2004,Paramount Pictures,84,Certified Fresh,185,Upright,32167706,45,155,30
747,Failure to Launch,24411322,88715192,64303870,27.5,3057,7985,10/3/2006,Paramount Pictures,24,Rotten,150,Spilled,438380,41,36,114
748,Race to Witch Mountain,24402214,67172594,42770380,36.3,3187,7656,13/03/2009,Walt Disney Studios Motion Pictures,42,Rotten,152,Spilled,348156,38,64,88
749,Contraband,24349815,66528000,42178185,36.6,2863,8505,13/01/2012,Universal Pictures,100,Fresh,6,Upright,1599,1,6,0
750,The Chronicles of Riddick,24289165,57761012,33471847,42,2757,8809,11/6/2004,Universal Pictures,29,Rotten,165,Upright,329497,37,48,117
751,The Haunted Mansion,24278410,75847266,51568856,32,3122,7776,26/11/2003,Walt Disney Studios Motion Pictures,13,Rotten,139,Spilled,134945,36,18,121
752,The Last Samurai,24271354,111127263,86855909,21.8,2908,8346,5/12/2003,Warner Bros.,66,Fresh,221,Upright,391950,46,146,75
753,TMNT,24255205,54149098,29893893,44.8,3110,7799,23/03/2007,Warner Bros.,34,Rotten,116,Upright,368171,28,40,76
754,No Good Deed,24250283,52543632,28293349,46.2,2175,11149,12/9/2014,Screen Gems,25,Rotten,12,Spilled,4244,5,3,9
755,Barbershop 2: Back in Business,24241612,65111277,40869665,37.2,2711,8941,6/2/2004,Metro-Goldwyn-Mayer (MGM),69,Fresh,125,Spilled,73582,38,86,39
756,"Me, Myself & Irene",24209385,90570999,66361614,26.7,3019,8019,23/06/2000,Twentieth Century Fox,47,Rotten,99,Spilled,448859,26,47,52
757,The Addams Family,24203754,113502426,89298672,21.3,2411,10038,22/11/1991,Paramount Pictures,63,Fresh,46,Upright,315126,8,29,17
758,Coach Carter,24182961,67264877,43081916,36,2524,9581,14/01/2005,Paramount Pictures,64,Fresh,150,Upright,406635,40,96,54
759,Maze Runner: The Death Cure,24167011,58032443,33865432,41.6,3787,6381,26/01/2018,Twentieth Century Fox,43,Rotten,168,Spilled,16926,34,72,96
760,Warcraft,24166110,47365290,23199180,51,3400,7107,10/6/2016,Universal Pictures,28,Rotten,228,Upright,63263,45,63,165
761,Con Air,24131738,101117573,76985835,23.9,2824,8545,6/6/1997,Walt Disney Studios Motion Pictures,55,Rotten,65,Upright,417177,17,36,29
762,Exodus: Gods and Kings,24115934,65014513,40898579,37.1,3503,6884,12/12/2014,Twentieth Century Fox,30,Rotten,202,Spilled,59982,47,61,141
763,White Noise,24113565,56386759,32273194,42.8,2261,10665,7/1/2005,Universal Pictures,7,Rotten,148,Spilled,188262,39,11,137
764,21,24105943,81159365,57053422,29.7,2648,9103,28/03/2008,Sony Pictures Releasing,36,Rotten,169,Upright,367740,40,60,109
765,Arrival,24074047,100546139,76472092,23.9,2317,10390,11/11/2016,Paramount Pictures,94,Certified Fresh,411,Upright,82412,56,387,24
766,Tower Heist,24025190,78046570,54021380,30.8,3367,7135,4/11/2011,Universal Pictures,67,Fresh,195,Spilled,57513,47,131,64
767,Pixels,24011616,78747585,54735969,30.5,3723,6449,24/07/2015,Sony Pictures Releasing,16,Rotten,195,Spilled,69854,40,32,163
768,The Chronicles of Narnia: The Voyage of the Dawn Treader,24005069,104386950,80381881,23,3555,6752,10/12/2010,Twentieth Century Fox,50,Rotten,165,Spilled,157324,41,82,83
769,Monster-in-Law,24000000,82931301,58931301,28.9,3424,7009,13/05/2005,New Line Cinema,17,Rotten,168,Spilled,433315,45,29,139
770,The Fast and the Furious: Tokyo Drift,23973840,62514415,38540575,38.4,3027,7920,16/06/2006,Universal Pictures,38,Rotten,136,Upright,535861,40,51,85
771,Bad Moms,23817340,113257297,89439957,21,3215,7408,29/07/2016,STX Entertainment,58,Rotten,165,Upright,40980,37,96,69
774,The Town,23808032,92186262,68378230,25.8,2861,8321,17/09/2010,Warner Bros.,93,Certified Fresh,227,Upright,141864,48,210,17
775,How to Lose a Guy in 10 Days,23774850,105813373,82038523,22.5,2923,8133,7/2/2003,Paramount Pictures,42,Rotten,149,Upright,802193,37,62,87
776,Rise of the Guardians,23773465,103412758,79639293,23,3653,6507,21/11/2012,DreamWorks,74,Certified Fresh,158,Upright,124130,36,117,41
777,Paul Blart: Mall Cop 2,23762435,71038190,47275755,33.4,3633,6540,17/04/2015,Sony Pictures Releasing,5,Rotten,60,Spilled,37469,16,3,57
778,The Fugitive,23758855,183875760,160116905,12.9,2340,10153,6/8/1993,Warner Bros.,86,Fresh,7,Upright,576,0,6,1
779,17 Again,23722310,64167069,40444759,37,3255,7287,17/04/2009,Warner Bros.,56,Rotten,146,Upright,465945,40,82,64
781,Fury,23702421,85817906,62115485,27.6,3173,7470,17/10/2014,Sony Pictures Releasing,100,Fresh,15,Upright,3081,0,15,0
782,Resident Evil: Extinction,23678580,50648679,26970099,46.8,2828,8372,21/09/2007,Screen Gems,24,Rotten,99,Spilled,390490,18,24,75
783,Tomb Raider,23633317,58250803,34617486,40.6,3854,6132,16/03/2018,Warner Bros.,52,Rotten,304,Spilled,10463,47,158,146
784,Open Season,23624548,85105259,61480711,27.8,3833,6163,29/09/2006,Sony Pictures Releasing,48,Rotten,101,Spilled,468577,30,48,53
785,Goosebumps,23618556,80080379,56461823,29.5,3501,6746,16/10/2015,Sony Pictures Releasing,78,Certified Fresh,160,Upright,51879,34,124,36
786,The Boss,23586645,63285885,39699240,37.3,3480,6777,8/4/2016,Universal Pictures,21,Rotten,187,Spilled,27080,45,40,147
787,Dinner for Schmucks,23527839,73026337,49498498,32.2,2911,8082,30/07/2010,DreamWorks,41,Rotten,189,Spilled,119406,43,78,111
788,Dracula Untold,23514615,56280355,32765740,41.8,2885,8150,10/10/2014,Universal Pictures,23,Rotten,132,Spilled,49490,26,31,101
790,The Amityville Horror,23507007,65233369,41726362,36,3323,7074,15/04/2005,Metro-Goldwyn-Mayer (MGM),23,Rotten,162,Spilled,360707,36,38,124
791,Be Cool,23450212,56046979,32596767,41.8,3216,7291,4/3/2005,Metro-Goldwyn-Mayer (MGM),30,Rotten,171,Spilled,212564,39,51,120
792,Save the Last Dance,23444930,91057006,67612076,25.8,2230,10513,12/1/2001,Paramount Pictures,52,Rotten,98,Spilled,31845749,32,51,47
794,Face/Off,23387530,112276146,88888616,20.8,2621,8923,27/06/1997,Paramount Pictures,92,Certified Fresh,86,Upright,450172,28,79,7
796,The Polar Express,23323463,162775358,139451895,14.3,3650,6389,10/11/2004,Warner Bros.,56,Rotten,203,Upright,241905,50,113,90
798,Mortal Kombat,23283887,70454098,47170211,33,2421,9617,18/08/1995,New Line Cinema,47,Rotten,38,Spilled,311583,9,18,20
799,Pineapple Express,23245025,87341380,64096355,26.6,3072,7566,6/8/2008,Sony Pictures Releasing,68,Fresh,201,Upright,302286,47,137,64
800,Alvin and the Chipmunks: Chipwrecked,23244744,133110742,109865998,17.5,3723,6243,16/12/2011,Twentieth Century Fox,11,Rotten,81,Spilled,66615,24,9,72
801,Eragon,23239907,75030163,51790256,31,3020,7695,15/12/2006,Twentieth Century Fox,16,Rotten,125,Spilled,519365,33,20,105
802,Hellboy,23172440,59623958,36451518,38.9,3028,7652,2/4/2004,Revolution Studios,81,Certified Fresh,201,Upright,458858,44,163,38
804,Double Jeopardy,23162542,116741558,93579016,19.8,2547,9094,24/09/1999,Paramount Pictures,27,Rotten,86,Upright,178162,23,23,63
805,The Mask,23117068,119938730,96821662,19.3,2360,9795,29/07/1994,New Line Cinema,77,Certified Fresh,52,Upright,994480,16,40,12
806,Eat Pray Love,23104523,80574010,57469487,28.7,3082,7496,13/08/2010,Sony Pictures Releasing,36,Rotten,202,Spilled,100372,45,73,129
808,The League of Extraordinary Gentlemen,23075892,66465204,43389312,34.7,3002,7686,11/7/2003,Twentieth Century Fox,17,Rotten,180,Spilled,422479,43,30,150
809,Smallfoot,23045635,83240103,60194468,27.7,4131,5578,28/09/2018,Warner Bros.,76,Certified Fresh,119,Upright,2051,21,90,29
810,Resident Evil: Apocalypse,23036273,51201453,28165180,45,3284,7014,10/9/2004,Screen Gems,20,Rotten,129,Upright,407890,29,26,103
811,Star Wars: Episode VI - Return of the Jedi,23019618,252583617,229563999,9.1,1002,22973,25/05/1983,Twentieth Century Fox,81,Certified Fresh,91,Upright,1011830,27,74,17
812,27 Dresses,23007725,76808654,53800929,30,3057,7526,18/01/2008,Twentieth Century Fox,40,Rotten,151,Spilled,606049,41,61,90
813,The Game Plan,22950971,90648202,67697231,25.3,3103,7396,28/09/2007,Walt Disney Studios Motion Pictures,29,Rotten,101,Upright,406926,31,29,72
816,Vantage Point,22874936,72266306,49391370,31.6,3149,7264,22/02/2008,Sony Pictures Releasing,34,Rotten,157,Spilled,373481,35,54,103
817,Jack Reacher: Never Go Back,22872490,58697076,35824586,39,3780,6050,21/10/2016,Paramount Pictures,37,Rotten,233,Spilled,31644,42,87,146
818,The Princess Diaries,22862269,108248956,85386687,21.1,2537,9011,3/8/2001,Walt Disney Studios Motion Pictures,47,Rotten,114,Upright,757799,31,54,60
819,Mission to Mars,22855247,60883407,38028160,37.5,3054,7483,10/3/2000,Walt Disney Studios Motion Pictures,25,Rotten,110,Spilled,53535,28,27,83
820,The Interpreter,22822455,72708161,49885706,31.4,2758,8275,22/04/2005,Universal Pictures,57,Rotten,194,Spilled,79238,46,110,84
821,Man on Fire,22751490,77911774,55160284,29.2,2980,7634,21/04/2004,Twentieth Century Fox,39,Rotten,168,Upright,423464,44,65,103
823,Mulan,22745143,120620254,97875111,18.9,2888,7875,19/06/1998,Walt Disney Studios Motion Pictures,86,Certified Fresh,74,Upright,611371,16,64,10
824,Insidious: Chapter 3,22692741,52218558,29525817,43.5,3002,7559,5/6/2015,Focus Features,59,Rotten,124,Spilled,32418,28,73,51
826,Unstoppable,22688457,81562942,58874485,27.8,3207,7074,12/11/2010,Twentieth Century Fox,86,Certified Fresh,191,Upright,104578,43,165,26
827,Funny People,22657780,51855045,29197265,43.7,3007,7535,31/07/2009,Universal Pictures,69,Fresh,237,Spilled,844988,60,163,74
828,Black Mass,22635037,62575678,39940641,36.2,3188,7100,18/09/2015,Warner Bros.,73,Certified Fresh,280,Upright,55480,52,204,76
829,Poltergeist,22620386,47425125,24804739,47.7,3240,6981,22/05/2015,Twentieth Century Fox,85,Certified Fresh,61,Upright,182197,8,52,9
830,The Time Machine,22610437,56832494,34222057,39.8,2944,7680,8/3/2002,DreamWorks Distribution,77,Fresh,35,Upright,19456,3,27,8
831,Bridge to Terabithia,22564612,82272442,59707830,27.4,3139,7188,16/02/2007,Walt Disney Studios Motion Pictures,85,Certified Fresh,157,Upright,468456,37,133,24
832,Training Day,22550788,76631907,54081119,29.4,2712,8315,5/10/2001,Warner Bros.,72,Fresh,158,Upright,300730,38,114,44
833,Dick Tracy,22543911,103738726,81194815,21.7,2332,9667,15/06/1990,Walt Disney Studios Motion Pictures,63,Fresh,49,Spilled,77201,12,31,18
834,The Mask of Zorro,22525855,94095523,71569668,23.9,2515,8956,17/07/1998,Sony Pictures Releasing,82,Certified Fresh,71,Upright,375206,15,58,13
836,Heaven Is for Real,22522221,91443253,68921032,24.6,2417,9318,16/04/2014,TriStar Pictures,49,Rotten,87,Upright,59712,26,43,44
837,The Lucky One,22518358,60457138,37938780,37.2,3155,7137,20/04/2012,Warner Bros.,21,Rotten,145,Upright,193790,37,30,115
838,Shallow Hal,22518295,70839203,48320908,31.8,2770,8129,9/11/2001,Twentieth Century Fox,50,Rotten,127,Spilled,621158,34,64,63
839,Life of Pi,22451514,124987023,102535509,18,2927,7670,21/11/2012,Twentieth Century Fox,87,Certified Fresh,245,Upright,169021,52,212,33
841,The Social Network,22445653,96962694,74517041,23.2,2771,8100,1/10/2010,Sony Pictures Releasing,96,Certified Fresh,313,Upright,203519,56,299,14
842,The Patriot,22413710,113330342,90916632,19.8,3061,7322,28/06/2000,Sony Pictures Releasing,61,Fresh,134,Upright,423024,32,82,52
843,Contagion,22403596,75658097,53254501,29.6,3222,6953,9/9/2011,Warner Bros.,84,Certified Fresh,256,Upright,83701,53,216,40
844,Now You See Me 2,22383146,65075540,42692394,34.4,3232,6925,10/6/2016,Lionsgate,34,Rotten,189,Spilled,66864,38,64,125
845,Walk the Line,22347341,119519402,97172061,18.7,2961,7547,18/11/2005,Twentieth Century Fox,83,Certified Fresh,209,Upright,545499,43,173,36
846,The General's Daughter,22332053,102705852,80373799,21.7,2856,7819,18/06/1999,Paramount Pictures,22,Rotten,89,Spilled,52751,25,20,69
847,Planes,22232291,90288712,68056421,24.6,3702,6005,9/8/2013,Walt Disney Studios Motion Pictures,25,Rotten,117,Spilled,72018,29,29,88
848,Disturbia,22224982,80209692,57984710,27.7,2925,7598,13/04/2007,DreamWorks,69,Fresh,174,Upright,1452492,46,120,54
849,Monster House,22217226,73661010,51443784,30.2,3553,6253,21/07/2006,Sony Pictures Releasing,75,Certified Fresh,161,Upright,199528,42,120,41
851,Freaky Friday,22203007,110230332,88027325,20.1,2954,7516,6/8/2003,Walt Disney Studios Motion Pictures,70,Fresh,23,Spilled,65734,4,16,7
852,Poseidon,22155410,60674817,38519407,36.5,3555,6232,12/5/2006,Warner Bros.,33,Rotten,201,Spilled,342047,47,66,135
855,Diary of a Wimpy Kid,22126166,64003625,41877459,34.6,3077,7190,19/03/2010,Twentieth Century Fox,52,Rotten,105,Spilled,103424,33,55,50
856,Ghost Rider: Spirit of Vengeance,22115334,51774002,29658668,42.7,3174,6967,17/02/2012,Sony Pictures Releasing,18,Rotten,113,Spilled,112745,21,20,93
857,It's Complicated,22100820,112735375,90634555,19.6,2887,7655,25/12/2009,Universal Pictures,58,Rotten,180,Upright,225228,44,104,76
858,Ladder 49,22088204,74541707,52453503,29.6,3260,6775,1/10/2004,Walt Disney Studios Motion Pictures,41,Rotten,164,Upright,343177,36,67,97
859,Road to Perdition,22079481,104454762,82375281,21.1,1797,12286,12/7/2002,DreamWorks Distribution,80,Certified Fresh,215,Upright,188673,46,173,42
860,Starship Troopers,22058773,54814377,32755604,40.2,2971,7424,7/11/1997,Sony Pictures Releasing,63,Fresh,63,Upright,224146,14,40,23
861,Star Trek: Insurrection,22052836,70187658,48134822,31.4,2620,8417,11/12/1998,Paramount Pictures,54,Rotten,68,Spilled,62770,15,37,31
862,Chronicle,22004098,64575175,42571077,34.1,2907,7569,3/2/2012,Twentieth Century Fox,85,Certified Fresh,180,Upright,115767,38,153,27
863,The Monuments Men,22003433,78031620,56028187,28.2,3083,7137,7/2/2014,Sony Pictures Releasing,31,Rotten,249,Spilled,72897,56,76,173
864,Hide and Seek,21959233,51100486,29141253,43,3005,7307,28/01/2005,Twentieth Century Fox,13,Rotten,157,Spilled,278247,39,20,137
866,Diary of a Mad Black Woman,21905089,50633099,28728010,43.3,1483,14770,25/02/2005,Lionsgate,16,Rotten,114,Upright,89152,32,18,96
867,Inspector Gadget,21889138,97403112,75513974,22.5,2814,7778,23/07/1999,Walt Disney Studios Motion Pictures,21,Rotten,63,Spilled,275579,21,13,50
868,Unknown,21856389,63686397,41830008,34.3,3043,7182,18/02/2011,Warner Bros.,55,Rotten,200,Spilled,75777,47,110,90
869,Stomp the Yard,21833312,61356221,39522909,35.6,2051,10645,12/1/2007,Screen Gems,25,Rotten,89,Upright,467981,34,22,67
871,Notting Hill,21811180,116089678,94278498,18.8,2747,7940,28/05/1999,Universal Pictures,83,Certified Fresh,100,Upright,508329,30,83,17
872,Neighbors 2: Sorority Rising,21760405,55455765,33695360,39.2,3384,6430,20/05/2016,Universal Pictures,63,Fresh,199,Spilled,51540,38,126,73
875,Underworld,21753759,51970690,30216931,41.9,2915,7462,19/09/2003,Screen Gems,31,Rotten,161,Upright,495821,38,50,111
876,Die Hard 2,21744661,117540947,95796286,18.5,2507,8673,6/7/1990,Twentieth Century Fox,68,Fresh,63,Upright,414701,17,43,20
877,Shaft,21714757,70334258,48619501,30.9,2337,9291,16/06/2000,Paramount Pictures,88,Certified Fresh,40,Upright,12075,6,35,5
880,Cats & Dogs,21707617,93385515,71677898,23.2,3040,7140,4/7/2001,Warner Bros.,53,Rotten,116,Spilled,444441,33,62,54
881,Eyes Wide Shut,21706163,55691208,33985045,39,2411,9002,16/07/1999,Warner Bros.,75,Certified Fresh,156,Upright,192430,41,117,39
882,Spy Game,21689125,62362560,40673435,34.8,2770,7830,21/11/2001,Universal Pictures,66,Fresh,133,Upright,114042,32,88,45
883,Lights Out,21688103,67268835,45580732,32.2,2818,7696,22/07/2016,Warner Bros.,76,Certified Fresh,173,Upright,27335,36,132,41
884,RoboCop,21681430,58607007,36925577,37,3372,6429,12/2/2014,Sony Pictures Releasing,89,Certified Fresh,64,Upright,226227,12,57,7
885,Bumblebee,21654047,127195589,105541542,17,3550,6099,21/12/2018,Paramount Pictures,92,Certified Fresh,235,Upright,9095,32,216,19
887,London Has Fallen,21635601,62524260,40888659,34.6,3490,6199,4/3/2016,Focus Features,26,Rotten,193,Spilled,36801,36,51,142
889,Little Man,21613176,58645052,37031876,36.8,2533,8532,14/07/2006,Revolution Studios,12,Rotten,90,Spilled,419431,29,11,79
890,When a Stranger Calls,21607203,47860214,26253011,45.2,2999,7204,3/2/2006,Screen Gems,38,Rotten,16,Spilled,32187,2,6,10
891,Fool's Gold,21589295,70231041,48641746,30.7,3125,6908,8/2/2008,Warner Bros.,11,Rotten,144,Spilled,356544,41,16,128
892,Tammy,21577049,84525432,62948383,25.5,3465,6227,2/7/2014,Warner Bros.,24,Rotten,181,Spilled,57546,47,43,138
893,"You, Me and Dupree",21525560,75628110,54102550,28.5,3131,6874,14/07/2006,Universal Pictures,20,Rotten,166,Spilled,448169,43,34,132
895,Pete's Dragon,21514095,76233151,54719056,28.2,3702,5811,12/8/2016,Walt Disney Studios Motion Pictures,54,Rotten,26,Upright,59229,3,14,12
896,American Reunion,21514080,57011521,35497441,37.7,3192,6740,6/4/2012,Universal Pictures,45,Rotten,182,Upright,338980,38,81,101
897,The Stepford Wives,21406781,59484742,38077961,36,3057,7002,11/6/2004,Paramount Pictures,26,Rotten,172,Spilled,210642,40,44,128
899,Safe Haven,21401594,71349120,49947526,30,3223,6640,14/02/2013,Relativity Media,13,Rotten,143,Upright,76005,41,18,125
901,The Forbidden Kingdom,21401121,52075270,30674149,41.1,3151,6791,18/04/2008,Lionsgate,64,Fresh,129,Upright,326688,32,82,47
902,The Hitman's Bodyguard,21384504,75468583,54084079,28.3,3377,6332,18/08/2017,Lionsgate,43,Rotten,214,Upright,26920,35,92,122
903,Ice Age: Collision Course,21373064,64063008,42689944,33.4,3992,5353,22/07/2016,Twentieth Century Fox,17,Rotten,117,Spilled,32967,30,20,97
905,Why Did I Get Married?,21353789,55204525,33850736,38.7,2011,10618,12/10/2007,Lionsgate,46,Rotten,41,Upright,18211,13,19,22
906,Turbo,21312625,83028128,61715503,25.7,3806,5599,17/07/2013,Twentieth Century Fox,67,Fresh,109,Upright,89513,26,73,36
907,Storks,21311407,72679278,51367871,29.3,3922,5433,23/09/2016,Warner Bros.,66,Fresh,136,Upright,24783,32,90,46
908,My Bloody Valentine,21241456,51545952,30304496,41.2,2534,8382,16/01/2009,Lionsgate,47,Rotten,17,Spilled,9328,2,8,9
909,Happy Feet Two,21237068,64006466,42769398,33.2,3606,5889,18/11/2011,Warner Bros.,45,Rotten,120,Upright,90899,34,54,66
910,Payback,21221526,81526121,60304595,26,2729,7776,5/2/1999,Paramount Pictures,54,Rotten,74,Upright,98929,22,40,34
912,Four Brothers,21176925,74494381,53317456,28.4,2533,8360,12/8/2005,Paramount Pictures,52,Rotten,134,Upright,392281,35,70,64
913,Waterworld,21171780,88246220,67074440,24,2268,9335,28/07/1995,Universal Pictures,45,Rotten,58,Spilled,230475,12,26,32
914,The Adjustment Bureau,21157730,62495645,41337915,33.8,2840,7449,4/3/2011,Universal Pictures,71,Fresh,255,Upright,104592,54,182,73
915,The Hitchhiker's Guide to the Galaxy,21103203,51085416,29982213,41.3,3133,6735,29/04/2005,Walt Disney Studios Motion Pictures,60,Fresh,198,Upright,233646,40,119,79
916,Bride Wars,21058173,58715510,37657337,35.9,3226,6527,9/1/2009,Twentieth Century Fox,11,Rotten,144,Spilled,375984,46,16,128
917,13 Going on 30,21054283,57231747,36177464,36.8,3438,6123,23/04/2004,Revolution Studios,65,Fresh,167,Upright,653610,39,108,59
918,Resident Evil: Retribution,21052227,42345531,21293304,49.7,3012,6989,14/09/2012,Screen Gems,29,Rotten,73,Spilled,241846,12,21,52
919,Project X,21051363,54731865,33680502,38.5,3055,6890,2/3/2012,Warner Bros.,75,Fresh,20,Spilled,8766,9,15,5
920,Law Abiding Citizen,21039502,73357727,52318225,28.7,2890,7280,16/10/2009,Overture Films,26,Rotten,159,Upright,517202,35,41,118
921,The Hunchback of Notre Dame,21037414,100138851,79101437,21,2778,7572,21/06/1996,Walt Disney Studios Motion Pictures,91,Fresh,23,Upright,2951,3,21,2
922,Valkyrie,21027007,83077833,62050826,25.3,2711,7756,25/12/2008,United Artists,62,Fresh,196,Upright,239365,48,122,74
923,The Forgotten,21022111,67133509,46111398,31.3,3104,6772,24/09/2004,Revolution Studios,32,Rotten,174,Spilled,183733,37,55,119
924,Journey to the Center of the Earth,21018141,101704370,80686229,20.7,2811,7477,11/7/2008,Warner Bros.,86,Fresh,29,Upright,9286,2,25,4
925,The Strangers,20997985,52597610,31599625,39.9,2466,8514,30/05/2008,Rogue Pictures,48,Rotten,164,Spilled,311246,39,78,86
926,Insomnia,20930169,67355513,46425344,31.1,2610,8019,24/05/2002,Warner Bros.,92,Certified Fresh,201,Upright,105176,49,185,16
927,Remember the Titans,20905831,115654751,94748920,18.1,1865,11209,29/09/2000,Walt Disney Studios Motion Pictures,73,Fresh,134,Upright,578045,35,98,36
929,The Woman in Black,20874072,54333290,33459218,38.4,2855,7311,3/2/2012,CBS Films,66,Fresh,188,Spilled,97732,45,125,63
930,Seabiscuit,20854735,120277854,99423119,17.3,1989,10485,25/07/2003,Universal Pictures,77,Certified Fresh,203,Upright,118368,48,157,46
931,The Grudge 2,20825300,39143839,18318539,53.2,3211,6485,13/10/2006,Sony Pictures Releasing,12,Rotten,76,Spilled,253374,22,9,67
933,Prisoners,20817053,61002302,40185249,34.1,3260,6385,20/09/2013,Warner Bros.,80,Certified Fresh,244,Upright,108042,57,196,48
935,Prom Night,20804941,43869350,23064409,47.4,2700,7705,11/4/2008,Screen Gems,45,Rotten,20,Spilled,20097,4,9,11
936,Looper,20801552,66486205,45684653,31.3,2992,6952,28/09/2012,TriStar Pictures,93,Certified Fresh,262,Upright,179928,56,243,19
937,This Is the End,20719162,101470202,80751040,20.4,3055,6782,12/6/2013,Sony Pictures Releasing,83,Certified Fresh,223,Upright,181895,46,185,38
938,The Bounty Hunter,20686423,67061228,46374805,30.8,3074,6729,19/03/2010,Sony Pictures Releasing,12,Rotten,146,Spilled,263924,41,18,128
939,Guess Who,20671446,68915888,48244442,30,3147,6568,25/03/2005,Sony Pictures Releasing,42,Rotten,151,Spilled,269572,39,63,88
940,Step Up,20659573,65328121,44668548,31.6,2467,8374,11/8/2006,Walt Disney Studios Motion Pictures,20,Rotten,105,Upright,615661,34,21,84
941,The Wedding Ringer,20649306,64460211,43810905,32,3003,6876,16/01/2015,Screen Gems,27,Rotten,107,Upright,40129,28,29,78
942,Barbershop,20627433,75782105,55154672,27.2,1605,12851,13/09/2002,Metro-Goldwyn-Mayer (MGM),82,Certified Fresh,125,Upright,55546,36,103,22
943,1408,20617667,71985628,51367961,28.6,2678,7698,22/06/2007,-,79,Certified Fresh,175,Upright,745356,41,139,36
944,Abominable,20612100,60716390,40104290,34,4242,4859,27/09/2019,Universal Pictures,67,Fresh,15,Spilled,9125,4,10,5
945,Contact,20584908,100920329,80335421,20.4,1923,10704,11/7/1997,Warner Bros.,63,Fresh,63,Upright,203673,21,40,23
946,Deja Vu,20574802,64038616,43463814,32.1,3108,6619,22/11/2006,Walt Disney Studios Motion Pictures,65,Fresh,20,Upright,4075,6,13,7
947,Blockers,20556350,60311495,39755145,34.1,3379,6083,6/4/2018,Universal Pictures,83,Certified Fresh,214,Spilled,4918,39,178,36
948,Baby Driver,20553320,107825862,87272542,19.1,3226,6371,28/06/2017,TriStar Pictures,93,Certified Fresh,367,Upright,62326,48,341,26
949,End of Days,20523595,66889043,46365448,30.7,2593,7915,24/11/1999,Universal Pictures,11,Rotten,101,Spilled,131169,26,11,90
951,Takers,20512304,57744720,37232416,35.5,2206,9298,27/08/2010,Screen Gems,29,Rotten,112,Upright,125452,25,32,80
952,Scary Movie 2,20503356,71308997,50805641,28.8,3220,6367,4/7/2001,Miramax,15,Rotten,109,Spilled,682770,31,16,93
953,Notorious,20497596,36843682,16346086,55.6,1638,12513,16/01/2009,Fox Searchlight Pictures,51,Rotten,144,Upright,97038,47,74,70
954,Mrs. Doubtfire,20468847,219195243,198726396,9.3,1605,12753,24/11/1993,Twentieth Century Fox,71,Fresh,49,Upright,1029182,9,35,14
955,The Lego Ninjago Movie,20433071,59281555,38848484,34.5,4047,5048,22/09/2017,Warner Bros.,55,Rotten,131,Spilled,18749,27,72,59
956,Life,20414775,64016268,43601493,31.9,2594,7869,16/04/1999,Universal Pictures,50,Rotten,54,Upright,50344,15,27,27
957,Lethal Weapon 2,20388800,147253986,126865186,13.8,1803,11308,7/7/1989,Warner Bros.,83,Fresh,36,Upright,250703,6,30,6
958,Legally Blonde,20377426,96520674,76143248,21.1,2620,7777,13/07/2001,Metro-Goldwyn-Mayer (MGM),69,Fresh,143,Upright,972165,36,99,44
959,The Last Exorcism,20366613,41034350,20667737,49.6,2874,7086,27/08/2010,Lionsgate,72,Fresh,158,Spilled,73333,33,113,45
960,The Upside,20355000,108252517,87897517,18.8,3080,6608,11/1/2019,STX Entertainment,41,Rotten,175,Upright,3717,39,71,104
961,Warm Bodies,20353967,66380662,46026695,30.7,3009,6764,1/2/2013,Lionsgate,81,Certified Fresh,201,Upright,131463,40,163,38
962,The Nutcracker and the Four Realms,20352491,54858851,34506360,37.1,3766,5404,2/11/2018,Walt Disney Studios Motion Pictures,33,Rotten,199,Spilled,2154,32,65,134
963,Clear and Present Danger,20348017,122187717,101839700,16.6,2378,8556,5/8/1994,Paramount Pictures,80,Certified Fresh,41,Upright,61686,10,33,8
964,John Q,20275194,71756802,51481608,28.3,2466,8221,15/02/2002,New Line Cinema,23,Rotten,131,Upright,169454,37,30,101
965,Annabelle Comes Home,20269723,74152591,53882868,27.3,3613,5610,26/06/2019,Warner Bros.,64,Fresh,194,Upright,9402,27,125,69
966,Friday Night Lights,20269025,61255921,40986896,33.1,2667,7599,8/10/2004,Universal Pictures,81,Certified Fresh,172,Upright,185760,44,140,32
967,Pain & Gain,20244505,49875291,29630786,40.6,3277,6177,26/04/2013,Paramount Pictures,51,Rotten,196,Spilled,85402,46,99,97
968,Barbershop: The Next Cut,20242415,54030051,33787636,37.5,2661,7607,15/04/2016,Warner Bros.,90,Certified Fresh,93,Upright,19790,32,84,9
969,Deepwater Horizon,20223544,61433527,41209983,32.9,3259,6205,30/09/2016,Lionsgate,83,Certified Fresh,251,Upright,45971,52,209,42
970,The Pink Panther,20220412,82226474,62006062,24.6,3477,5815,10/2/2006,Sony Pictures Releasing,90,Fresh,31,Upright,57463,1,28,3
971,We Were Soldiers,20212543,78122718,57910175,25.9,3143,6430,1/3/2002,Paramount Pictures,63,Fresh,146,Upright,203162,39,92,54
972,Eight Below,20188176,81612565,61424389,24.7,3066,6584,17/02/2006,Walt Disney Studios Motion Pictures,72,Certified Fresh,152,Upright,374295,42,110,42
973,Rambo: First Blood Part II,20176217,150415432,130239215,13.4,2074,9728,22/05/1985,TriStar Pictures,36,Rotten,42,Upright,99682,6,15,27
974,What Happens in Vegas,20172474,80277646,60105172,25.1,3215,6274,9/5/2008,Twentieth Century Fox,26,Rotten,131,Upright,501679,39,34,97
975,Kicking & Screaming,20159925,52842724,32682799,38.2,3455,5835,13/05/2005,Universal Pictures,40,Rotten,141,Spilled,70215,37,57,84
976,Lost in Space,20154919,69117629,48962710,29.2,3306,6096,3/4/1998,New Line Cinema,28,Rotten,83,Spilled,173846,20,23,60
977,Silent Hill,20152598,46982632,26830034,42.9,2926,6887,21/04/2006,Sony Pictures Releasing,31,Rotten,100,Upright,367014,22,31,69
978,Entrapment,20145595,87704396,67558801,23,2814,7159,30/04/1999,Twentieth Century Fox,38,Rotten,82,Spilled,204744,18,31,51
979,Bewitched,20131130,63313159,43182029,31.8,3174,6342,24/06/2005,Sony Pictures Releasing,24,Rotten,186,Spilled,215412,48,45,141
981,xXx: Return of Xander Cage,20130142,44898413,24768271,44.8,3651,5513,20/01/2017,Paramount Pictures,45,Rotten,140,Spilled,25176,27,63,77
982,Final Destination 3,20125000,54098051,33973051,37.2,2880,6987,10/2/2006,New Line Cinema,43,Rotten,116,Spilled,538594,30,50,66
983,The Mexican,20108829,66845033,46736204,30.1,2951,6814,2/3/2001,DreamWorks Distribution,55,Rotten,132,Spilled,132290,36,72,60
985,Zookeeper,20065617,80360843,60295226,25,3482,5762,8/7/2011,Sony Pictures Releasing,14,Rotten,131,Spilled,44664,34,18,113
987,Ray,20039730,75331600,55291870,26.6,2006,9989,29/10/2004,Universal Pictures,80,Certified Fresh,204,Upright,214472,43,163,41
988,Enemy of the State,20038573,111549836,91511263,18,2393,8373,20/11/1998,Walt Disney Studios Motion Pictures,71,Fresh,84,Upright,372945,22,60,24
989,Julie & Julia,20027956,94125426,74097470,21.3,2354,8508,7/8/2009,Sony Pictures Releasing,77,Certified Fresh,223,Upright,363421,58,171,52
991,The Manchurian Candidate,20018620,65955630,45937010,30.4,2867,6982,30/07/2004,Paramount Pictures,96,Certified Fresh,56,Upright,31317,10,54,2
992,Rocky IV,19991537,127873716,107882179,15.6,1325,15087,27/11/1985,United Artists,40,Rotten,48,Upright,352412,11,19,29
993,Pitch Perfect 3,19928525,104897530,84969005,19,3447,5781,22/12/2017,Universal Pictures,30,Rotten,141,Spilled,16754,29,42,99
994,102 Dalmatians,19883351,66957026,47073675,29.7,2704,7353,22/11/2000,Walt Disney Studios Motion Pictures,31,Rotten,90,Spilled,406503,28,28,62
995,Ouija,19875995,50856010,30980015,39.1,2858,6954,24/10/2014,Universal Pictures,6,Rotten,87,Spilled,30393,22,5,82
996,Kick-Ass,19828687,48071303,28242616,41.2,3065,6469,16/04/2010,Lionsgate,76,Certified Fresh,258,Upright,285351,51,196,62
997,The Unborn,19810585,42670410,22859825,46.4,2357,8405,9/1/2009,Universal Pictures,10,Rotten,118,Spilled,831822,24,12,106
998,The Cable Guy,19806226,60240295,40434069,32.9,2657,7454,14/06/1996,Sony Pictures Releasing,53,Rotten,77,Spilled,471287,24,41,36
999,Spawn,19738749,54870175,35131426,36,2536,7783,1/8/1997,New Line Cinema,18,Rotten,45,Spilled,186093,11,8,37
